id,release_date,movie,production_budget,domestic_gross,worldwide_gross,total_revenue,net_revenue,ROI,genres,averagerating,runtime_minutes
1,"Dec 18, 2009",Avatar,425000000,760507625,2776345279,3536852904,3111852904,732.2006832941177,Horror,6.1,93.0
2,"May 20, 2011",Pirates of the Caribbean: On Stranger Tides,410600000,241063875,1045663875,1286727750,876127750,213.37743546030202,"Action,Adventure,Fantasy",6.6,136.0
3,"Jun 7, 2019",Dark Phoenix,350000000,42762350,149762350,192524700,-157475300,-44.99294285714286,"Action,Adventure,Sci-Fi",6.0,113.0
4,"May 1, 2015",Avengers: Age of Ultron,330600000,459005868,1403013963,1862019831,1531419831,463.224389292196,"Action,Adventure,Sci-Fi",7.3,141.0
7,"Apr 27, 2018",Avengers: Infinity War,300000000,678815482,2048134200,2726949682,2426949682,808.9832273333334,"Action,Adventure,Sci-Fi",8.5,149.0
9,"Nov 17, 2017",Justice League,300000000,229024295,655945209,884969504,584969504,194.98983466666667,"Action,Adventure,Fantasy",6.5,120.0
10,"Nov 6, 2015",Spectre,300000000,200074175,879620923,1079695098,779695098,259.898366,"Action,Adventure,Thriller",6.8,148.0
11,"Jul 20, 2012",The Dark Knight Rises,275000000,448139099,1084439099,1532578198,1257578198,457.3011629090909,"Action,Thriller",8.4,164.0
12,"May 25, 2018",Solo: A Star Wars Story,275000000,213767512,393151347,606918859,331918859,120.69776690909092,"Action,Adventure,Fantasy",7.0,135.0
13,"Jul 2, 2013",The Lone Ranger,275000000,89302115,260002115,349304230,74304230,27.019720000000003,"Action,Adventure,Western",6.4,150.0
14,"Mar 9, 2012",John Carter,275000000,73058679,282778100,355836779,80836779,29.39519236363636,"Action,Adventure,Sci-Fi",6.6,132.0
15,"Nov 24, 2010",Tangled,260000000,200821936,586477240,787299176,527299176,202.8073753846154,"Adventure,Animation,Comedy",7.8,100.0
17,"May 6, 2016",Captain America: Civil War,250000000,408084349,1140069413,1548153762,1298153762,519.2615048,"Action,Adventure,Sci-Fi",7.8,147.0
18,"Mar 25, 2016",Batman v Superman: Dawn of Justice,250000000,330360194,867500281,1197860475,947860475,379.14419000000004,"Action,Adventure,Fantasy",6.5,151.0
19,"Dec 14, 2012",The Hobbit: An Unexpected Journey,250000000,303003568,1017003568,1320007136,1070007136,428.00285440000005,"Adventure,Family,Fantasy",7.9,169.0
21,"Dec 13, 2013",The Hobbit: The Desolation of Smaug,250000000,258366855,960366855,1218733710,968733710,387.49348399999997,"Adventure,Fantasy",7.8,161.0
22,"Dec 17, 2014",The Hobbit: The Battle of the Five Armies,250000000,255119788,945577621,1200697409,950697409,380.2789636,"Adventure,Fantasy",7.4,144.0
23,"Apr 14, 2017",The Fate of the Furious,250000000,225764765,1234846267,1460611032,1210611032,484.2444128,"Action,Crime,Thriller",6.7,136.0
25,"May 26, 2017",Pirates of the Caribbean: Dead Men Tell No Tales,230000000,172558876,788241137,960800013,730800013,317.73913608695653,"Action,Adventure,Fantasy",6.6,129.0
27,"May 4, 2012",The Avengers,225000000,623279547,1517935897,2141215444,1916215444,851.6513084444445,"Action,Adventure,Sci-Fi",8.1,143.0
29,"Jun 14, 2013",Man of Steel,225000000,291045518,667999518,959045036,734045036,326.2422382222222,"Action,Adventure,Sci-Fi",7.1,143.0
31,"Jul 3, 2012",The Amazing Spider-Man,220000000,262030663,757890267,1019920930,799920930,363.6004227272727,"Action,Adventure,Sci-Fi",7.0,136.0
32,"May 18, 2012",Battleship,220000000,65233400,313477717,378711117,158711117,72.14141681818181,"Action,Adventure,Sci-Fi",5.8,131.0
33,"Jun 21, 2017",Transformers: The Last Knight,217000000,130168683,602893340,733062023,516062023,237.81660046082948,"Action,Adventure,Sci-Fi",5.2,154.0
34,"Jun 12, 2015",Jurassic World,215000000,652270625,1648854864,2301125489,2086125489,970.290925116279,"Action,Adventure,Sci-Fi",7.0,124.0
35,"May 25, 2012",Men in Black 3,215000000,179020854,654213485,833234339,618234339,287.5508553488372,"Action,Adventure,Comedy",6.8,106.0
37,"Jun 27, 2014",Transformers: Age of Extinction,210000000,245439076,1104039076,1349478152,1139478152,542.6086438095238,"Action,Adventure,Sci-Fi",5.7,165.0
39,"May 14, 2010",Robin Hood,210000000,105487148,322459006,427946154,217946154,103.78388285714286,"Action,Adventure,Drama",6.6,140.0
39,"May 14, 2010",Robin Hood,210000000,105487148,322459006,427946154,217946154,103.78388285714286,"Action,Drama",6.3,92.0
39,"May 14, 2010",Robin Hood,210000000,105487148,322459006,427946154,217946154,103.78388285714286,"Action,Adventure,Thriller",5.3,116.0
42,"Feb 16, 2018",Black Panther,200000000,700059566,1348258224,2048317790,1848317790,924.158895,"Action,Adventure,Sci-Fi",7.3,134.0
44,"Jun 15, 2018",Incredibles 2,200000000,608581744,1242520711,1851102455,1651102455,825.5512274999999,"Action,Adventure,Animation",7.7,118.0
45,"Dec 16, 2016",Rogue One: A Star Wars Story,200000000,532177324,1049102856,1581280180,1381280180,690.64009,"Action,Adventure,Sci-Fi",7.8,133.0
46,"Jun 17, 2016",Finding Dory,200000000,486295561,1021215193,1507510754,1307510754,653.755377,"Adventure,Animation,Comedy",7.3,97.0
47,"Jun 18, 2010",Toy Story 3,200000000,415004880,1068879522,1483884402,1283884402,641.942201,"Adventure,Animation,Comedy",8.3,103.0
48,"May 3, 2013",Iron Man 3,200000000,408992272,1215392272,1624384544,1424384544,712.192272,"Action,Adventure,Sci-Fi",7.2,130.0
51,"Mar 5, 2010",Alice in Wonderland,200000000,334191110,1025491110,1359682220,1159682220,579.84111,"Adventure,Family,Fantasy",6.5,108.0
51,"Mar 5, 2010",Alice in Wonderland,200000000,334191110,1025491110,1359682220,1159682220,579.84111,"Fantasy,Musical",6.5,99.0
52,"Nov 8, 2012",Skyfall,200000000,304360277,1110526981,1414887258,1214887258,607.443629,"Action,Adventure,Thriller",7.8,143.0
53,"Jun 21, 2013",Monsters University,200000000,268488329,743588329,1012076658,812076658,406.038329,"Adventure,Animation,Comedy",7.3,104.0
54,"Mar 8, 2013",Oz the Great and Powerful,200000000,234770996,490359051,725130047,525130047,262.5650235,"Adventure,Family,Fantasy",6.3,130.0
55,"May 23, 2014",X-Men: Days of Future Past,200000000,233921534,747862775,981784309,781784309,390.8921545,"Action,Adventure,Sci-Fi",8.0,132.0
56,"May 2, 2014",The Amazing Spider-Man 2,200000000,202853933,708996336,911850269,711850269,355.9251345,"Action,Adventure,Sci-Fi",6.6,142.0
57,"Jun 24, 2011",Cars 2,200000000,191450875,560155383,751606258,551606258,275.803129,"Adventure,Animation,Comedy",6.2,106.0
60,"Nov 16, 2018",Fantastic Beasts: The Crimes of Grindelwald,200000000,159555901,652220086,811775987,611775987,305.8879935,"Adventure,Family,Fantasy",6.6,134.0
62,"Jun 17, 2011",Green Lantern,200000000,116601172,219535492,336136664,136136664,68.068332,"Action,Adventure,Sci-Fi",5.5,114.0
64,"Jun 29, 2011",Transformers: Dark of the Moon,195000000,352390543,1123790543,1476181086,1281181086,657.0159415384614,"Action,Adventure,Sci-Fi",6.2,154.0
65,"Jun 9, 2017",The Mummy,195000000,80101125,409953905,490055030,295055030,151.3102717948718,"Action,Adventure,Fantasy",5.5,110.0
66,"Mar 1, 2013",Jack the Giant Slayer,195000000,65187603,197687603,262875206,67875206,34.80779794871795,"Adventure,Fantasy",6.3,114.0
67,"Apr 3, 2015",Furious 7,190000000,353007020,1518722794,1871729814,1681729814,885.1209547368421,"Action,Crime,Thriller",7.2,137.0
68,"May 16, 2013",Star Trek Into Darkness,190000000,228778661,467381584,696160245,506160245,266.40012894736844,"Action,Adventure,Sci-Fi",7.7,132.0
69,"Jun 21, 2013",World War Z,190000000,202359711,531514650,733874361,543874361,286.24966368421053,"Action,Adventure,Horror",7.0,116.0
70,"May 10, 2013",The Great Gatsby,190000000,144840419,351040419,495880838,305880838,160.9899147368421,"Drama,Romance",7.3,143.0
72,"Jul 12, 2013",Pacific Rim,190000000,101802906,411002906,512805812,322805812,169.8977957894737,"Action,Adventure,Sci-Fi",6.9,131.0
73,"Nov 25, 2015",The Good Dinosaur,187500000,123087120,333771037,456858157,269358157,143.65768373333333,"Adventure,Animation,Comedy",6.7,93.0
74,"May 2, 2008",Iron Man,186000000,318604126,585171547,903775673,717775673,385.9008994623656,"Comedy,Drama,Family",5.6,84.0
77,"Jun 22, 2012",Brave,185000000,237282182,554606532,791888714,606888714,328.0479535135135,"Adventure,Animation,Comedy",7.1,93.0
78,"Mar 10, 2017",Kong: Skull Island,185000000,168052812,561072059,729124871,544124871,294.1215518918919,"Action,Adventure,Fantasy",6.6,118.0
79,"Jul 22, 2016",Star Trek Beyond,185000000,158848340,335802233,494650573,309650573,167.3786881081081,"Action,Adventure,Sci-Fi",7.1,122.0
80,"Oct 6, 2017",Blade Runner 2049,185000000,92054159,259357408,351411567,166411567,89.95219837837838,"Drama,Mystery,Sci-Fi",8.0,164.0
81,"May 24, 2019",Aladdin,182000000,246734314,619234314,865968628,683968628,375.8069384615385,"Adventure,Comedy,Family",7.4,128.0
82,"Nov 3, 2017",Thor: Ragnarok,180000000,315058289,846980024,1162038313,982038313,545.5768405555556,"Action,Adventure,Comedy",7.9,130.0
84,"May 30, 2014",Maleficent,180000000,241407328,758536735,999944063,819944063,455.52447944444447,"Action,Adventure,Family",7.0,97.0
85,"Nov 18, 2016",Fantastic Beasts and Where to Find Them,180000000,234037575,802402853,1036440428,856440428,475.80023777777774,"Adventure,Family,Fantasy",7.3,132.0
88,"Jul 1, 2016",The Legend of Tarzan,180000000,126643061,348902025,475545086,295545086,164.19171444444444,"Action,Adventure,Drama",6.3,110.0
89,"Nov 23, 2011",Hugo,180000000,73864507,180047784,253912291,73912291,41.06238388888889,"Adventure,Drama,Family",7.5,126.0
89,"Nov 23, 2011",Hugo,180000000,73864507,180047784,253912291,73912291,41.06238388888889,Documentary,7.9,80.0
90,"Jul 21, 2017",Valerian and the City of a Thousand Planets,180000000,40479370,215098356,255577726,75577726,41.98762555555556,"Action,Adventure,Fantasy",6.5,137.0
91,"Feb 6, 2015",Jupiter Ascending,179000000,47482519,181982519,229465038,50465038,28.192758659217876,"Action,Adventure,Sci-Fi",5.3,127.0
93,"May 27, 2016",X-Men: Apocalypse,178000000,155442489,542537546,697980035,519980035,292.1236151685393,"Action,Adventure,Sci-Fi",7.0,144.0
94,"Aug 10, 2018",The Meg,178000000,145443742,529530715,674974457,496974457,279.1991331460674,"Action,Horror,Sci-Fi",5.7,113.0
95,"Jun 6, 2014",Edge of Tomorrow,178000000,100206256,370541256,470747512,292747512,164.46489438202246,"Action,Sci-Fi",7.9,113.0
96,"Mar 8, 2019",Captain Marvel,175000000,426525952,1123061550,1549587502,1374587502,785.4785725714286,"Action,Adventure,Sci-Fi",7.0,123.0
97,"Apr 15, 2016",The Jungle Book,175000000,364001123,962854547,1326855670,1151855670,658.20324,Animation,7.0,64.0
97,"Apr 15, 2016",The Jungle Book,175000000,364001123,962854547,1326855670,1151855670,658.20324,"Adventure,Drama,Family",7.4,106.0
98,"Jun 19, 2015",Inside Out,175000000,356461711,854235992,1210697703,1035697703,591.8272588571429,"Crime,Drama",4.6,93.0
98,"Jun 19, 2015",Inside Out,175000000,356461711,854235992,1210697703,1035697703,591.8272588571429,Family,7.3,59.0
98,"Jun 19, 2015",Inside Out,175000000,356461711,854235992,1210697703,1035697703,591.8272588571429,"Adventure,Animation,Comedy",8.2,95.0
98,"Jun 19, 2015",Inside Out,175000000,356461711,854235992,1210697703,1035697703,591.8272588571429,"Biography,Documentary,History",7.5,75.0
99,"Jul 7, 2017",Spider-Man: Homecoming,175000000,334201140,880166350,1214367490,1039367490,593.92428,"Action,Adventure,Sci-Fi",7.5,133.0
100,"Aug 5, 2016",Suicide Squad,175000000,325100054,746059887,1071159941,896159941,512.0913948571429,"Action,Adventure,Fantasy",6.0,123.0
2,"Nov 22, 2017",Coco,175000000,209726015,798008101,1007734116,832734116,475.8480662857143,"Adventure,Animation,Comedy",8.4,105.0
2,"Nov 22, 2017",Coco,175000000,209726015,798008101,1007734116,832734116,475.8480662857143,Horror,7.4,98.0
5,"Jun 16, 2017",Cars 3,175000000,152901115,383541369,536442484,361442484,206.53856228571428,"Adventure,Animation,Comedy",6.8,102.0
11,"May 12, 2017",King Arthur: Legend of the Sword,175000000,39175066,139630336,178805402,3805402,2.1745154285714285,"Action,Adventure,Drama",6.8,126.0
12,"Dec 25, 2013",47 Ronin,175000000,38362475,151716815,190079290,15079290,8.616737142857144,"Action,Adventure,Drama",6.3,128.0
13,"Jun 22, 2018",Jurassic World: Fallen Kingdom,170000000,417719760,1305772799,1723492559,1553492559,913.819152352941,"Action,Adventure,Sci-Fi",6.2,128.0
14,"Aug 1, 2014",Guardians of the Galaxy,170000000,333172112,770867516,1104039628,934039628,549.4350752941177,"Action,Adventure,Comedy",8.1,121.0
15,"May 7, 2010",Iron Man 2,170000000,312433331,621156389,933589720,763589720,449.1704235294118,"Action,Adventure,Sci-Fi",7.0,124.0
16,"Apr 4, 2014",Captain America: The Winter Soldier,170000000,259746958,714401889,974148847,804148847,473.02873352941174,"Action,Adventure,Sci-Fi",7.8,136.0
17,"Jul 11, 2014",Dawn of the Planet of the Apes,170000000,208545589,710644566,919190155,749190155,440.70009117647055,"Action,Adventure,Drama",7.6,130.0
19,"Jun 1, 2012",Snow White and the Huntsman,170000000,155136755,401021746,556158501,386158501,227.1520594117647,"Action,Adventure,Drama",6.1,127.0
22,"Mar 29, 2019",Dumbo,170000000,113883318,345004422,458887740,288887740,169.93396470588235,"Adventure,Family,Fantasy",6.6,112.0
23,"May 22, 2015",Tomorrowland,170000000,93436322,206627518,300063840,130063840,76.50814117647059,"Action,Adventure,Family",6.4,130.0
23,"May 22, 2015",Tomorrowland,170000000,93436322,206627518,300063840,130063840,76.50814117647059,Documentary,6.3,70.0
24,"Feb 14, 2019",Alita: Battle Angel,170000000,85710210,402976036,488686246,318686246,187.46249764705883,"Action,Adventure,Sci-Fi",7.5,122.0
25,"May 31, 2019",Godzilla: King of the Monsters,170000000,85576941,299276941,384853882,214853882,126.38463647058825,"Action,Adventure,Fantasy",6.7,132.0
26,"May 27, 2016",Alice Through the Looking Glass,170000000,77042381,276928112,353970493,183970493,108.21793705882352,"Adventure,Family,Fantasy",6.2,113.0
27,"May 21, 2010",Shrek Forever After,165000000,238736787,756244673,994981460,829981460,503.0190666666667,"Adventure,Animation,Comedy",6.3,93.0
28,"Nov 4, 2016",Doctor Strange,165000000,232641920,676404566,909046486,744046486,450.93726424242425,"Action,Adventure,Fantasy",7.5,115.0
29,"Nov 7, 2014",Big Hero 6,165000000,222527828,652127828,874655656,709655656,430.094336969697,"Action,Adventure,Animation",7.8,102.0
30,"Mar 26, 2010",How to Train Your Dragon,165000000,217581232,494870992,712452224,547452224,331.78922666666665,"Action,Adventure,Animation",8.1,98.0
31,"Nov 2, 2012",Wreck-It Ralph,165000000,189412677,496511521,685924198,520924198,315.71163515151517,"Adventure,Animation,Comedy",7.7,101.0
32,"Nov 5, 2014",Interstellar,165000000,188017894,666379375,854397269,689397269,417.8165266666666,"Adventure,Drama,Sci-Fi",8.6,169.0
33,"Jun 24, 2016",Independence Day: Resurgence,165000000,103144286,384169424,487313710,322313710,195.34164242424242,"Action,Adventure,Sci-Fi",5.2,120.0
35,"Mar 17, 2017",Beauty and the Beast,160000000,504014165,1259199706,1763213871,1603213871,1002.0086693750001,"Drama,Fantasy,Romance",6.4,112.0
35,"Mar 17, 2017",Beauty and the Beast,160000000,504014165,1259199706,1763213871,1603213871,1002.0086693750001,"Family,Fantasy,Musical",7.2,129.0
36,"Dec 21, 2018",Aquaman,160000000,335061807,1146894640,1481956447,1321956447,826.2227793750001,"Action,Adventure,Fantasy",7.1,143.0
38,"Jul 16, 2010",Inception,160000000,292576195,835524642,1128100837,968100837,605.0630231250001,"Action,Adventure,Sci-Fi",8.8,148.0
39,"Nov 20, 2015",The Hunger Games: Mockingjay - Part 2,160000000,281723902,648986787,930710689,770710689,481.694180625,"Action,Adventure,Sci-Fi",6.6,137.0
41,"May 16, 2014",Godzilla,160000000,200676069,529076069,729752138,569752138,356.09508625,"Action,Adventure,Sci-Fi",6.4,123.0
42,"Jun 3, 2011",X-Men: First Class,160000000,146408305,355408305,501816610,341816610,213.63538125,"Action,Adventure,Sci-Fi",7.7,131.0
44,"Jul 14, 2010",The Sorcerer's Apprentice,160000000,63150991,217986320,281137311,121137311,75.710819375,"Action,Adventure,Family",6.1,109.0
46,"Jun 10, 2016",Warcraft,160000000,47225655,425522281,472747936,312747936,195.46746,"Action,Adventure,Fantasy",6.9,123.0
47,"Sep 30, 2016",Deepwater Horizon,156000000,61433527,122603824,184037351,28037351,17.972660897435897,"Action,Drama,History",7.1,107.0
48,"Dec 10, 2010",The Chronicles of Narnia: The Voyage of the Dawn Treader,155000000,104386950,418186950,522573900,367573900,237.14445161290323,"Adventure,Family,Fantasy",6.3,113.0
50,"Mar 23, 2018",Pacific Rim: Uprising,155000000,59874525,290930148,350804673,195804673,126.32559548387097,"Action,Adventure,Sci-Fi",5.6,111.0
52,"Jul 14, 2017",War for the Planet of the Apes,152000000,146880162,489592267,636472429,484472429,318.7318611842105,"Action,Adventure,Drama",7.5,140.0
55,"Jun 2, 2017",Wonder Woman,150000000,412563408,821133378,1233696786,1083696786,722.464524,"Action,Adventure,Fantasy",7.5,141.0
55,"Jun 2, 2017",Wonder Woman,150000000,412563408,821133378,1233696786,1083696786,722.464524,Sci-Fi,4.2,60.0
55,"Jun 2, 2017",Wonder Woman,150000000,412563408,821133378,1233696786,1083696786,722.464524,"Documentary,Drama,Sport",6.9,75.0
56,"Nov 22, 2013",Frozen,150000000,400738009,1272469910,1673207919,1523207919,1015.4719460000001,"Adventure,Drama,Sport",6.2,93.0
56,"Nov 22, 2013",Frozen,150000000,400738009,1272469910,1673207919,1523207919,1015.4719460000001,"Fantasy,Romance",5.4,92.0
56,"Nov 22, 2013",Frozen,150000000,400738009,1272469910,1673207919,1523207919,1015.4719460000001,"Adventure,Animation,Comedy",7.5,102.0
57,"Mar 4, 2016",Zootopia,150000000,341268248,1019429616,1360697864,1210697864,807.1319093333333,"Adventure,Animation,Comedy",8.0,108.0
62,"Nov 23, 2016",Moana,150000000,248757044,637517365,886274409,736274409,490.849606,"Adventure,Animation,Comedy",7.6,107.0
66,"Nov 8, 2013",Thor: The Dark World,150000000,206362140,644602516,850964656,700964656,467.3097706666667,"Action,Adventure,Fantasy",6.9,112.0
69,"Jul 21, 2017",Dunkirk,150000000,190068280,499837368,689905648,539905648,359.93709866666666,"Action,Drama,History",7.9,106.0
70,"May 6, 2011",Thor,150000000,181030624,449326618,630357242,480357242,320.2381613333333,"Action,Adventure,Fantasy",7.0,115.0
74,"May 26, 2011",Kung Fu Panda 2,150000000,165249063,664837547,830086610,680086610,453.39107333333334,"Action,Adventure,Animation",7.2,90.0
75,"May 15, 2015",Mad Max: Fury Road,150000000,153636354,370098020,523734374,373734374,249.15624933333334,"Action,Adventure,Sci-Fi",8.1,120.0
78,"Mar 29, 2018",Ready Player One,150000000,137690172,579290136,716980308,566980308,377.986872,"Action,Adventure,Sci-Fi",7.5,140.0
83,"Jul 1, 2010",The Last Airbender,150000000,131772187,319713881,451486068,301486068,200.99071199999997,"Action,Adventure,Family",4.1,103.0
87,"Mar 30, 2012",Wrath of the Titans,150000000,83670083,305270083,388940166,238940166,159.293444,"Action,Adventure,Fantasy",5.7,99.0
89,"May 11, 2012",Dark Shadows,150000000,79727149,238202668,317929817,167929817,111.95321133333334,"Comedy,Fantasy,Horror",6.2,113.0
90,"Jun 28, 2013",White House Down,150000000,73103784,205440387,278544171,128544171,85.696114,"Action,Drama,Thriller",6.4,131.0
91,"Feb 12, 2010",The Wolfman,150000000,62189884,142634358,204824242,54824242,36.54949466666667,"Drama,Fantasy,Horror",5.8,103.0
92,"Feb 17, 2017",The Great Wall,150000000,45157105,334486852,379643957,229643957,153.09597133333332,"Action,Adventure,Fantasy",6.0,103.0
92,"Feb 17, 2017",The Great Wall,150000000,45157105,334486852,379643957,229643957,153.09597133333332,Documentary,6.5,72.0
93,"Oct 9, 2015",Pan,150000000,35088320,151525973,186614293,36614293,24.409528666666667,"Adventure,Comedy,Family",5.8,111.0
94,"Mar 11, 2011",Mars Needs Moms,150000000,21392758,39549758,60942516,-89057484,-59.371655999999994,"Adventure,Animation,Family",5.4,88.0
97,"Jun 8, 2012",Madagascar 3: Europe's Most Wanted,145000000,216391482,746921271,963312753,818312753,564.3536227586206,"Adventure,Animation,Comedy",6.8,93.0
99,"Jun 13, 2014",How to Train Your Dragon 2,145000000,177002924,614586270,791589194,646589194,445.9235820689655,"Action,Adventure,Animation",7.8,102.0
100,"Jun 16, 1999",Tarzan,145000000,171091819,448191819,619283638,474283638,327.09216413793104,"Adventure,Animation,Drama",4.8,94.0
1,"Mar 7, 2014",Mr. Peabody & Sherman,145000000,111506430,269806430,381312860,236312860,162.97438620689655,"Adventure,Animation,Comedy",6.8,92.0
2,"Nov 21, 2012",Rise of the Guardians,145000000,103412758,306900902,410313660,265313660,182.97493793103448,"Action,Adventure,Animation",7.3,97.0
3,"Apr 8, 2005",Sahara,145000000,68671925,121671925,190343850,45343850,31.271620689655172,"Adventure,Animation,Comedy",5.6,86.0
4,"Jul 15, 2016",Ghostbusters,144000000,128350574,229008658,357359232,213359232,148.16613333333333,"Action,Comedy,Fantasy",5.2,116.0
10,"Jul 22, 2011",Captain America: The First Avenger,140000000,176654505,370569776,547224281,407224281,290.8744864285714,"Action,Adventure,Sci-Fi",6.9,124.0
11,"Jan 29, 2016",Kung Fu Panda 3,140000000,143528619,517599142,661127761,521127761,372.23411500000003,"Action,Adventure,Animation",7.1,95.0
13,"Mar 27, 2013",G.I. Joe: Retaliation,140000000,122523060,375740705,498263765,358263765,255.90268928571427,"Action,Adventure,Sci-Fi",5.8,110.0
16,"Dec 12, 2014",Exodus: Gods and Kings,140000000,65014513,268314513,333329026,193329026,138.09216142857144,"Action,Adventure,Drama",6.0,150.0
17,"Jul 1, 2016",The BFG,140000000,55483770,199646680,255130450,115130450,82.23603571428572,"Adventure,Family,Fantasy",6.4,117.0
18,"Feb 26, 2016",Gods of Egypt,140000000,31153464,138836756,169990220,29990220,21.421585714285715,"Action,Adventure,Fantasy",5.4,127.0
26,"Mar 22, 2013",The Croods,135000000,187168425,573068425,760236850,625236850,463.1384074074074,"Action,Adventure,Animation",7.2,98.0
27,"Dec 25, 2015",The Revenant,135000000,183637894,532938302,716576196,581576196,430.7971822222222,"Action,Adventure,Biography",8.0,156.0
27,"Dec 25, 2015",The Revenant,135000000,183637894,532938302,716576196,581576196,430.7971822222222,Horror,6.0,80.0
29,"Mar 4, 2011",Rango,135000000,123477607,245724600,369202207,234202207,173.4831162962963,"Adventure,Animation,Comedy",7.2,107.0
31,"Jul 17, 2013",Turbo,135000000,83028130,286896578,369924708,234924708,174.01830222222225,"Adventure,Animation,Comedy",6.4,96.0
32,"Jun 3, 2016",Teenage Mutant Ninja Turtles: Out of the Shadows,135000000,82051601,245328374,327379975,192379975,142.5036851851852,"Action,Adventure,Comedy",6.0,112.0
33,"Nov 18, 2011",Happy Feet Two,135000000,64006466,157956466,221962932,86962932,64.41698666666666,"Adventure,Animation,Comedy",5.9,100.0
35,"Nov 2, 2018",The Nutcracker and the Four Realms,132900000,54858851,170293899,225152750,92252750,69.41516177577127,"Adventure,Family,Fantasy",5.5,99.0
36,"Jun 29, 2005",War of the Worlds,132000000,234280354,606836535,841116889,709116889,537.2097643939394,Sci-Fi,5.8,50.0
37,"Nov 26, 2014",Penguins of Madagascar,132000000,83350911,366942531,450293442,318293442,241.13139545454544,"Adventure,Animation,Comedy",6.7,92.0
38,"Nov 22, 2013",The Hunger Games: Catching Fire,130000000,424668047,864868047,1289536094,1159536094,891.9508415384616,"Action,Adventure,Sci-Fi",7.5,146.0
41,"Jul 6, 2018",Ant-Man and the Wasp,130000000,216648740,623144660,839793400,709793400,545.994923076923,"Action,Adventure,Comedy",7.1,118.0
43,"Jul 17, 2015",Ant-Man,130000000,180202163,518858449,699060612,569060612,437.7389323076923,"Action,Adventure,Comedy",7.3,117.0
44,"Mar 27, 2015",Home,130000000,177397510,385997896,563395406,433395406,333.38108153846156,Drama,6.0,76.0
44,"Mar 27, 2015",Home,130000000,177397510,385997896,563395406,433395406,333.38108153846156,Drama,7.5,127.0
44,"Mar 27, 2015",Home,130000000,177397510,385997896,563395406,433395406,333.38108153846156,"Adventure,Animation,Comedy",6.6,94.0
44,"Mar 27, 2015",Home,130000000,177397510,385997896,563395406,433395406,333.38108153846156,"Drama,Romance",6.8,90.0
44,"Mar 27, 2015",Home,130000000,177397510,385997896,563395406,433395406,333.38108153846156,Drama,7.0,112.0
44,"Mar 27, 2015",Home,130000000,177397510,385997896,563395406,433395406,333.38108153846156,"Drama,Horror,Thriller",3.9,87.0
44,"Mar 27, 2015",Home,130000000,177397510,385997896,563395406,433395406,333.38108153846156,Drama,7.2,103.0
44,"Mar 27, 2015",Home,130000000,177397510,385997896,563395406,433395406,333.38108153846156,"Drama,Romance,Thriller",8.4,71.0
45,"Dec 19, 2018",Mary Poppins Returns,130000000,171958438,341528518,513486956,383486956,294.9899661538462,"Comedy,Family,Fantasy",6.9,130.0
46,"Oct 28, 2011",Puss in Boots,130000000,149260504,554987477,704247981,574247981,441.72921615384615,"Action,Adventure,Animation",6.6,90.0
47,"Nov 5, 2010",Megamind,130000000,148415853,321887208,470303061,340303061,261.7715853846154,"Action,Animation,Comedy",7.3,95.0
49,"Apr 11, 2014",Rio 2,130000000,131538435,492846291,624384726,494384726,380.2959430769231,"Adventure,Animation,Comedy",6.3,101.0
50,"Jul 23, 2010",Salt,130000000,118311368,290650494,408961862,278961862,214.5860476923077,"Action,Mystery,Thriller",6.4,100.0
51,"Mar 28, 2014",Noah,130000000,101200044,352831065,454031109,324031109,249.25469923076923,"Action,Adventure,Drama",5.8,138.0
51,"Mar 28, 2014",Noah,130000000,101200044,352831065,454031109,324031109,249.25469923076923,"Drama,Thriller",6.5,105.0
52,"Dec 21, 2011",The Adventures of Tintin,130000000,77591831,373993951,451585782,321585782,247.37367846153847,"Action,Adventure,Animation",7.3,107.0
53,"May 31, 2013",After Earth,130000000,60522097,251499665,312021762,182021762,140.01674,"Action,Adventure,Drama",4.8,100.0
55,"Jul 19, 2013",R.I.P.D.,130000000,33618855,79076678,112695533,-17304467,-13.311128461538463,"Action,Adventure,Comedy",5.6,96.0
56,"Feb 22, 2019",How to Train Your Dragon: The Hidden World,129000000,160791800,519258283,680050083,551050083,427.1706069767442,"Action,Adventure,Animation",7.6,104.0
58,"May 19, 2000",Dinosaur,127500000,137748063,356148063,493896126,366396126,287.3695105882353,Animation,7.2,77.0
59,"Mar 3, 2017",Logan,127000000,226277068,615461394,841738462,714738462,562.7861905511811,"Comedy,Drama,Family",6.2,94.0
59,"Mar 3, 2017",Logan,127000000,226277068,615461394,841738462,714738462,562.7861905511811,"Action,Drama,Sci-Fi",8.1,137.0
60,"Dec 19, 2014",Night at the Museum: Secret of the Tomb,127000000,113746621,353756621,467503242,340503242,268.11278897637794,"Adventure,Comedy,Family",6.2,98.0
62,"Nov 21, 2014",The Hunger Games: Mockingjay - Part 1,125000000,337135885,766575131,1103711016,978711016,782.9688128,"Action,Adventure,Sci-Fi",6.6,123.0
67,"Apr 29, 2011",Fast Five,125000000,210031325,630163454,840194779,715194779,572.1558232,"Action,Crime,Thriller",7.3,130.0
68,"Aug 8, 2014",Teenage Mutant Ninja Turtles,125000000,191204754,485004754,676209508,551209508,440.9676064,"Action,Adventure,Comedy",5.8,101.0
69,"Dec 16, 2011",Sherlock Holmes: A Game of Shadows,125000000,186848418,535663443,722511861,597511861,478.0094888,"Action,Adventure,Crime",7.5,129.0
71,"Mar 31, 2017",The Boss Baby,125000000,175003033,510878762,685881795,560881795,448.705436,"Adventure,Animation,Comedy",6.3,97.0
72,"Apr 1, 2010",Clash of the Titans,125000000,163214888,493214888,656429776,531429776,425.14382079999996,"Action,Adventure,Fantasy",5.8,106.0
73,"Nov 4, 2016",Trolls,125000000,153707064,344150134,497857198,372857198,298.2857584,"Adventure,Animation,Comedy",6.5,92.0
74,"May 19, 1998",Godzilla,125000000,136314294,376000000,512314294,387314294,309.8514352,"Action,Adventure,Sci-Fi",6.4,123.0
75,"Jun 8, 2012",Prometheus,125000000,126477084,402448265,528925349,403925349,323.1402792,"Adventure,Mystery,Sci-Fi",7.0,124.0
76,"Aug 10, 2012",The Bourne Legacy,125000000,113203870,280355920,393559790,268559790,214.847832,"Action,Adventure,Thriller",6.7,135.0
78,"Jul 13, 2018",Skyscraper,125000000,68420120,304115534,372535654,247535654,198.0285232,"Action,Adventure,Thriller",5.8,102.0
79,"Aug 3, 2012",Total Recall,125000000,58877969,211856088,270734057,145734057,116.5872456,"Action,Adventure,Mystery",6.3,118.0
81,"Jan 13, 2017",Monster Trucks,125000000,33370166,61642798,95012964,-29987036,-23.989628800000002,"Action,Adventure,Comedy",5.7,104.0
86,"Jul 29, 2016",Jason Bourne,120000000,162192920,416168316,578361236,458361236,381.96769666666665,"Action,Thriller",6.6,123.0
88,"Nov 21, 2012",Life of Pi,120000000,124987022,620912003,745899025,625899025,521.5825208333333,"Adventure,Drama,Fantasy",7.9,127.0
90,"Apr 13, 2018",Rampage,120000000,101028233,428056280,529084513,409084513,340.9037608333333,"Action,Adventure,Sci-Fi",6.1,107.0
92,"Aug 9, 2013",Elysium,120000000,93050117,286192091,379242208,259242208,216.03517333333335,"Action,Drama,Sci-Fi",6.6,109.0
93,"Apr 19, 2013",Oblivion,120000000,89107235,287916633,377023868,257023868,214.18655666666666,"Action,Adventure,Sci-Fi",7.0,124.0
93,"Apr 19, 2013",Oblivion,120000000,89107235,287916633,377023868,257023868,214.18655666666666,Thriller,8.0,116.0
94,"Mar 24, 2017",Power Rangers,120000000,85364450,142531552,227896002,107896002,89.913335,"Action,Adventure,Sci-Fi",6.0,124.0
96,"Feb 12, 2014",RoboCop,120000000,58607007,242981799,301588806,181588806,151.324005,"Action,Crime,Sci-Fi",6.2,117.0
98,"Aug 7, 2015",Fantastic Four,120000000,56117548,167849187,223966735,103966735,86.63894583333334,"Action,Adventure,Drama",4.3,100.0
100,"Jul 22, 2005",The Island,120000000,35818913,163018913,198837826,78837826,65.69818833333333,"Drama,Romance",5.1,95.0
100,"Jul 22, 2005",The Island,120000000,35818913,163018913,198837826,78837826,65.69818833333333,"Comedy,Drama",6.2,134.0
2,"Jun 23, 2010",Knight and Day,117000000,76423035,258751370,335174405,218174405,186.47385042735044,"Action,Adventure,Comedy",6.3,109.0
3,"Oct 5, 2018",Venom,116000000,213511408,853628605,1067140013,951140013,819.9482870689656,"Action,Sci-Fi,Thriller",6.7,112.0
3,"Oct 5, 2018",Venom,116000000,213511408,853628605,1067140013,951140013,819.9482870689656,Thriller,3.0,92.0
8,"Jul 26, 2013",The Wolverine,115000000,132556852,416456852,549013704,434013704,377.40322086956525,"Action,Adventure,Sci-Fi",6.7,126.0
13,"Dec 25, 2010",Gulliver's Travels,112000000,42779261,232017848,274797109,162797109,145.35456160714287,"Adventure,Comedy,Family",4.9,85.0
14,"Dec 15, 2017",Ferdinand,111000000,84410380,289847930,374258310,263258310,237.16964864864866,"Adventure,Animation,Comedy",6.7,108.0
15,"May 18, 2018",Deadpool 2,110000000,324591735,786680557,1111272292,1001272292,910.2475381818183,"Action,Adventure,Comedy",7.8,119.0
16,"Oct 4, 2013",Gravity,110000000,274092705,693698673,967791378,857791378,779.8103436363637,"Drama,Sci-Fi,Thriller",7.7,91.0
19,"May 29, 2015",San Andreas,110000000,155190832,456258539,611449371,501449371,455.86306454545456,"Action,Adventure,Drama",6.1,114.0
20,"Jul 29, 2011",The Smurfs,110000000,142614158,563749323,706363481,596363481,542.148619090909,"Adventure,Animation,Comedy",5.5,103.0
25,"Jun 28, 2000",The Patriot,110000000,113330342,215300000,328630342,218630342,198.75485636363638,Documentary,7.3,72.0
26,"Mar 7, 2014",300: Rise of an Empire,110000000,106580051,330780051,437360102,327360102,297.60009272727274,"Action,Fantasy,War",6.2,102.0
28,"Dec 21, 2016",Passengers,110000000,100014699,302239672,402254371,292254371,265.6857918181818,"Drama,Romance,Sci-Fi",7.0,116.0
29,"Jan 14, 2011",The Green Hornet,110000000,98780042,229155503,327935545,217935545,198.12322272727272,"Action,Comedy,Crime",5.8,119.0
31,"Oct 7, 2011",Real Steel,110000000,85463309,263880341,349343650,239343650,217.58513636363634,"Action,Drama,Family",7.1,127.0
32,"Jun 11, 2010",The A-Team,110000000,77222099,177241171,254463270,144463270,131.33024545454546,"Action,Adventure,Thriller",6.8,117.0
33,"Jul 31, 2013",The Smurfs 2,110000000,71017784,348547523,419565307,309565307,281.4230063636364,"Adventure,Animation,Comedy",5.4,105.0
36,"Nov 1, 2013",Ender's Game,110000000,61737191,127983283,189720474,79720474,72.47315818181819,"Action,Adventure,Fantasy",6.6,114.0
40,"Mar 31, 2017",Ghost in the Shell,110000000,40563557,167910690,208474247,98474247,89.52204272727273,"Action,Drama,Sci-Fi",6.4,107.0
45,"Dec 25, 2001",Ali,109000000,58183966,87683966,145867932,36867932,33.82379082568807,Drama,6.4,88.0
45,"Dec 25, 2001",Ali,109000000,58183966,87683966,145867932,36867932,33.82379082568807,Drama,7.7,110.0
46,"Oct 2, 2015",The Martian,108000000,228433663,655271443,883705106,775705106,718.2454685185185,"Adventure,Drama,Sci-Fi",8.0,144.0
47,"Nov 23, 2016",Allied,106000000,40098064,119266661,159364725,53364725,50.34408018867924,"Action,Drama,Romance",7.1,124.0
52,"Jul 22, 2016",Ice Age: Collision Course,105000000,64063008,402156682,466219690,361219690,344.0187523809524,"Adventure,Animation,Comedy",5.7,94.0
54,"Sep 22, 2017",Kingsman: The Golden Circle,104000000,100234838,408803696,509038534,405038534,389.46012884615385,"Action,Adventure,Comedy",6.8,141.0
58,"Mar 9, 2018",A Wrinkle in Time,103000000,100478608,133401882,233880490,130880490,127.06843689320388,"Adventure,Family,Fantasy",4.2,109.0
62,"Dec 21, 2018",Bumblebee,102000000,127195589,465195589,592391178,490391178,480.7756647058824,"Action,Adventure,Sci-Fi",6.9,114.0
63,"Oct 26, 2012",Cloud Atlas,102000000,27108272,130673154,157781426,55781426,54.68767254901961,"Action,Drama,Mystery",7.4,172.0
69,"Dec 25, 2012",Django Unchained,100000000,162805434,449948323,612753757,512753757,512.7537570000001,"Drama,Western",8.4,165.0
70,"Dec 22, 2010",Little Fockers,100000000,148438600,310650574,459089174,359089174,359.089174,"Comedy,Romance",5.5,98.0
74,"Aug 6, 2010",The Other Guys,100000000,119219978,170936470,290156448,190156448,190.156448,"Action,Comedy,Crime",6.7,107.0
76,"Dec 25, 2013",The Wolf of Wall Street,100000000,116900694,389870414,506771108,406771108,406.77110799999997,"Biography,Crime,Drama",8.2,180.0
77,"May 24, 2013",Epic,100000000,107518682,262794441,370313123,270313123,270.31312299999996,"Adventure,Animation,Family",6.7,102.0
81,"Aug 17, 2012",The Expendables 2,100000000,85028192,311979256,397007448,297007448,297.007448,"Action,Adventure,Thriller",6.6,103.0
84,"Jul 25, 2014",Hercules,100000000,72688614,243388614,316077228,216077228,216.07722800000002,"Action,Adventure,Fantasy",6.0,98.0
84,"Jul 25, 2014",Hercules,100000000,72688614,243388614,316077228,216077228,216.07722800000002,Comedy,6.2,112.0
85,"Dec 10, 2010",The Tourist,100000000,67631157,278731369,346362526,246362526,246.362526,"Action,Adventure,Thriller",6.0,103.0
90,"Sep 24, 2010",Legend of the Guardians: The Owls of Ga'Hoole,100000000,55675313,139716717,195392030,95392030,95.39203,"Action,Adventure,Animation",7.0,97.0
94,"Mar 15, 2019",Wonder Park,100000000,45216793,115149422,160366215,60366215,60.366215000000004,"Adventure,Animation,Comedy",5.7,85.0
96,"Aug 15, 2014",The Expendables 3,100000000,39322544,209461378,248783922,148783922,148.783922,"Action,Adventure,Thriller",6.1,126.0
98,"Mar 12, 2010",Green Zone,100000000,35497337,97523020,133020357,33020357,33.020357,"Action,Drama,Thriller",6.8,115.0
99,"Oct 20, 2017",Geostorm,100000000,33700160,220796009,254496169,154496169,154.496169,"Action,Sci-Fi,Thriller",5.3,109.0
100,"Dec 25, 2015",Point Break,100000000,28782481,126704591,155487072,55487072,55.487072000000005,"Action,Crime,Sport",5.3,114.0
1,"Dec 11, 2015",In the Heart of the Sea,100000000,25020758,89693309,114714067,14714067,14.714067,"Action,Adventure,Biography",6.9,122.0
2,"Apr 18, 2014",Transcendence,100000000,23022309,103039258,126061567,26061567,26.061567000000004,Drama,6.1,98.0
2,"Apr 18, 2014",Transcendence,100000000,23022309,103039258,126061567,26061567,26.061567000000004,"Action,Drama,Sci-Fi",6.3,119.0
4,"Dec 14, 2018",Mortal Engines,100000000,15951040,85287417,101238457,1238457,1.238457,"Action,Adventure,Fantasy",6.1,128.0
7,"Nov 6, 2015",The Peanuts Movie,99000000,130178411,250091610,380270021,281270021,284.1111323232323,"Adventure,Animation,Comedy",7.1,88.0
9,"Nov 21, 2018",Robin Hood,99000000,30824628,84747441,115572069,16572069,16.739463636363634,"Action,Adventure,Drama",6.6,140.0
9,"Nov 21, 2018",Robin Hood,99000000,30824628,84747441,115572069,16572069,16.739463636363634,"Action,Drama",6.3,92.0
9,"Nov 21, 2018",Robin Hood,99000000,30824628,84747441,115572069,16572069,16.739463636363634,"Action,Adventure,Thriller",5.3,116.0
12,"May 19, 2017",Alien: Covenant,97000000,74262031,238521247,312783278,215783278,222.45698762886596,"Horror,Sci-Fi,Thriller",6.4,122.0
13,"Mar 13, 2015",Cinderella,95000000,201151353,534551353,735702706,640702706,674.4239010526317,"Drama,Family,Fantasy",6.9,105.0
14,"Jul 13, 2012",Ice Age: Continental Drift,95000000,161321843,879765137,1041086980,946086980,995.8810315789474,"Adventure,Animation,Comedy",6.6,88.0
15,"Dec 28, 2001",Black Hawk Down,95000000,108638745,159691085,268329830,173329830,182.45245263157895,Documentary,7.8,57.0
16,"May 27, 2010",Sex and the City 2,95000000,95347692,294680778,390028470,295028470,310.5562842105263,"Comedy,Drama,Romance",4.4,146.0
17,"Feb 12, 2010",Percy Jackson & the Olympians: The Lightning Thief,95000000,88768303,223050874,311819177,216819177,228.23071263157897,"Adventure,Family,Fantasy",5.9,118.0
18,"Aug 10, 2012",The Campaign,95000000,86907746,104907746,191815492,96815492,101.91104421052633,Comedy,6.1,85.0
18,"Aug 10, 2012",The Campaign,95000000,86907746,104907746,191815492,96815492,101.91104421052633,Documentary,6.9,60.0
19,"Nov 12, 2010",Unstoppable,95000000,81562942,165720921,247283863,152283863,160.29880315789472,"Action,Thriller",6.8,98.0
19,"Nov 12, 2010",Unstoppable,95000000,81562942,165720921,247283863,152283863,160.29880315789472,Documentary,4.3,65.0
19,"Nov 12, 2010",Unstoppable,95000000,81562942,165720921,247283863,152283863,160.29880315789472,"Action,Crime",6.5,116.0
19,"Nov 12, 2010",Unstoppable,95000000,81562942,165720921,247283863,152283863,160.29880315789472,Documentary,8.1,84.0
23,"Aug 19, 2016",Ben-Hur,95000000,26410477,91669648,118080125,23080125,24.29486842105263,"Action,Adventure,Drama",5.7,123.0
24,"Feb 6, 2015",Seventh Son,95000000,17725785,108874967,126600752,31600752,33.263949473684214,"Action,Adventure,Fantasy",5.5,102.0
29,"Feb 13, 2015",Kingsman: The Secret Service,94000000,128261724,404561724,532823448,438823448,466.833455319149,"Action,Adventure,Comedy",7.7,129.0
31,"Aug 5, 2011",Rise of the Planet of the Apes,93000000,176760185,470986200,647746385,554746385,596.5014892473118,"Action,Drama,Sci-Fi",7.6,105.0
34,"Feb 14, 2013",A Good Day to Die Hard,92000000,67349198,304249198,371598396,279598396,303.9113,"Action,Thriller",5.3,98.0
37,"Dec 25, 2013",The Secret Life of Walter Mitty,91000000,58236838,187861183,246098021,155098021,170.4373857142857,"Adventure,Comedy,Drama",7.3,114.0
38,"Dec 20, 2017",Jumanji: Welcome to the Jungle,90000000,404508916,964496193,1369005109,1279005109,1421.1167877777777,"Action,Adventure,Comedy",7.0,119.0
42,"Dec 25, 2009",Sherlock Holmes,90000000,209028679,498438212,707466891,617466891,686.0743233333334,Adventure,5.4,77.0
46,"Apr 15, 2011",Rio,90000000,143619809,487519809,631139618,541139618,601.2662422222222,"Adventure,Animation,Comedy",6.9,96.0
46,"Apr 15, 2011",Rio,90000000,143619809,487519809,631139618,541139618,601.2662422222222,Documentary,8.3,90.0
46,"Apr 15, 2011",Rio,90000000,143619809,487519809,631139618,541139618,601.2662422222222,Drama,2.6,87.0
51,"Dec 20, 2011",The Girl with the Dragon Tattoo,90000000,102515793,239373970,341889763,251889763,279.87751444444444,"Crime,Drama,Mystery",7.8,158.0
52,"Jul 11, 1997",Contact,90000000,100920329,165900000,266820329,176820329,196.4670322222222,"Documentary,History",7.3,79.0
52,"Jul 11, 1997",Contact,90000000,100920329,165900000,266820329,176820329,196.4670322222222,Documentary,8.7,172.0
55,"Sep 23, 2016",The Magnificent Seven,90000000,93432655,162525156,255957811,165957811,184.3975677777778,"Action,Adventure,Western",6.9,132.0
56,"Dec 18, 2015",Alvin and the Chipmunks: The Road Chip,90000000,85886987,249517956,335404943,245404943,272.6721588888889,"Adventure,Animation,Comedy",5.1,92.0
59,"Jul 24, 2015",Pixels,90000000,78765986,244041804,322807790,232807790,258.67532222222223,"Action,Comedy",4.6,100.0
59,"Jul 24, 2015",Pixels,90000000,78765986,244041804,322807790,232807790,258.67532222222223,"Action,Comedy,Sci-Fi",5.6,105.0
63,"Apr 22, 2005",The Interpreter,90000000,72708161,162753837,235461998,145461998,161.62444222222223,"Comedy,Drama",6.7,113.0
64,"Aug 7, 2013",Percy Jackson: Sea of Monsters,90000000,68559554,200859554,269419108,179419108,199.35456444444443,"Adventure,Family,Fantasy",5.8,106.0
66,"Jun 10, 2016",Now You See Me 2,90000000,65075540,328325007,393400547,303400547,337.1117188888889,"Action,Adventure,Comedy",6.5,129.0
68,"Apr 4, 1997",The Saint,90000000,61363304,169400000,230763304,140763304,156.40367111111112,Drama,6.4,96.0
70,"Mar 16, 2018",Tomb Raider,90000000,58250803,273477501,331728304,241728304,268.58700444444446,"Action,Adventure,Fantasy",6.3,119.0
73,"Apr 25, 1997",Volcano,90000000,47546796,120100000,167646796,77646796,86.27421777777778,Drama,7.2,99.0
73,"Apr 25, 1997",Volcano,90000000,47546796,120100000,167646796,77646796,86.27421777777778,"Comedy,Drama",6.9,104.0
76,"Aug 19, 2011",Conan the Barbarian,90000000,21295021,63356133,84651154,-5348846,-5.943162222222222,"Action,Adventure,Fantasy",5.2,113.0
77,"Oct 21, 2011",The Three Musketeers,90000000,20377913,139877913,160255826,70255826,78.06202888888889,"Action,Adventure,Romance",5.8,110.0
77,"Oct 21, 2011",The Three Musketeers,90000000,20377913,139877913,160255826,70255826,78.06202888888889,Adventure,3.7,112.0
78,"Apr 21, 2017",The Promise,90000000,8224288,10551417,18775705,-71224295,-79.13810555555555,"Drama,History",6.1,133.0
78,"Apr 21, 2017",The Promise,90000000,8224288,10551417,18775705,-71224295,-79.13810555555555,Thriller,5.8,90.0
78,"Apr 21, 2017",The Promise,90000000,8224288,10551417,18775705,-71224295,-79.13810555555555,"Drama,Horror,Thriller",6.1,114.0
79,"Nov 24, 2010",The Nutcracker in 3D,90000000,195459,20466016,20661475,-69338525,-77.04280555555556,"Action,Family,Fantasy",4.3,110.0
80,"Dec 13, 2017",Bright,90000000,0,0,0,-90000000,-100.0,"Action,Crime,Fantasy",6.4,117.0
84,"Sep 14, 2018",The Predator,88000000,51024708,159487563,210512271,122512271,139.21848977272728,"Action,Adventure,Sci-Fi",5.4,107.0
85,"Jul 8, 2005",Fantastic Four,87500000,154696080,333132750,487828830,400328830,457.51866285714283,"Action,Adventure,Drama",4.3,100.0
88,"Dec 22, 2000",Cast Away,85000000,233632142,427230516,660862658,575862658,677.48548,"Adventure,Drama",6.3,90.0
95,"Mar 21, 2014",Divergent,85000000,150947895,276014965,426962860,341962860,402.30924705882353,"Action,Adventure,Mystery",6.7,139.0
96,"Sep 28, 2012",Hotel Transylvania,85000000,148313048,378505812,526818860,441818860,519.7868941176471,"Animation,Comedy,Family",7.1,91.0
97,"Apr 5, 2019",Shazam!,85000000,139606856,362899733,502506589,417506589,491.1842223529412,"Action,Adventure,Comedy",7.4,132.0
99,"Feb 10, 2012",Safe House,85000000,126181630,208542162,334723792,249723792,293.7926964705882,"Action,Adventure,Crime",6.8,115.0
5,"Nov 4, 2011",Tower Heist,85000000,78046570,150422946,228469516,143469516,168.78766588235294,"Action,Comedy,Crime",6.2,104.0
7,"Mar 30, 2012",Mirror Mirror,85000000,64935167,173613482,238548649,153548649,180.6454694117647,"Adventure,Comedy,Drama",5.6,106.0
14,"Nov 23, 2011",Arthur Christmas,85000000,46462469,149717124,196179593,111179593,130.7995211764706,"Adventure,Animation,Comedy",7.1,97.0
15,"Jan 20, 2017",xXx: Return of Xander Cage,85000000,44898413,345033359,389931772,304931772,358.7432611764706,"Action,Adventure,Thriller",5.2,107.0
17,"Jul 30, 2010",Cats & Dogs: The Revenge of Kitty Galore,85000000,43585753,113026383,156612136,71612136,84.24957176470588,"Action,Comedy,Family",4.3,82.0
19,"Mar 15, 2002",Showtime,85000000,37948765,78948765,116897530,31897530,37.52650588235294,"Drama,Fantasy,Musical",4.2,100.0
24,"May 9, 1997",Father's Day,85000000,28681080,35681080,64362160,-20637840,-24.279811764705883,"Action,Comedy,Horror",6.0,99.0
24,"May 9, 1997",Father's Day,85000000,28681080,35681080,64362160,-20637840,-24.279811764705883,Drama,6.1,128.0
25,"Dec 20, 2017",The Greatest Showman,84000000,174340174,386665550,561005724,477005724,567.8639571428572,"Biography,Drama,Musical",7.6,105.0
28,"Jul 19, 2013",RED 2,84000000,53262560,141507355,194769915,110769915,131.86894642857143,"Action,Comedy,Crime",6.6,116.0
29,"Jun 23, 2006",Click,82500000,137355633,237685089,375040722,292540722,354.59481454545454,"Drama,Horror,Mystery",3.6,127.0
31,"Feb 14, 2008",Jumper,82500000,80172128,222640812,302812940,220312940,267.04598787878786,"Biography,Documentary,Drama",8.0,5.0
34,"Aug 13, 2010",The Expendables,82000000,103068524,268268174,371336698,289336698,352.8496317073171,"Action,Adventure,Thriller",6.5,103.0
38,"Mar 23, 2012",The Hunger Games,80000000,408010692,677923379,1085934071,1005934071,1257.4175887499998,"Action,Adventure,Sci-Fi",7.2,142.0
39,"May 26, 2011",The Hangover Part II,80000000,254464305,586464305,840928610,760928610,951.1607625,"Comedy,Mystery",6.5,102.0
41,"Feb 10, 2017",The Lego Batman Movie,80000000,175750384,310660018,486410402,406410402,508.01300249999997,"Action,Animation,Comedy",7.3,104.0
42,"Sep 25, 2015",Hotel Transylvania 2,80000000,169700110,469500298,639200408,559200408,699.0005100000001,"Animation,Comedy,Family",6.7,89.0
44,"May 7, 1999",The Mummy,80000000,155385488,416385488,571770976,491770976,614.7137200000001,"Action,Adventure,Fantasy",5.5,110.0
48,"Jul 12, 2013",Grown Ups 2,80000000,133668525,247023808,380692333,300692333,375.86541625,Comedy,5.4,101.0
49,"Dec 16, 2011",Alvin and the Chipmunks: Chipwrecked,80000000,133107389,349088523,482195912,402195912,502.74489000000005,"Adventure,Animation,Comedy",4.4,87.0
52,"Feb 19, 2010",Shutter Island,80000000,128012934,299461782,427474716,347474716,434.343395,"Mystery,Thriller",8.1,138.0
62,"Dec 17, 2010",Yogi Bear,80000000,100246011,204774690,305020701,225020701,281.27587625,"Adventure,Animation,Comedy",4.6,80.0
64,"Jan 15, 2010",The Book of Eli,80000000,94835059,158750817,253585876,173585876,216.982345,"Action,Adventure,Drama",6.9,118.0
68,"Oct 17, 2014",Fury,80000000,85817906,210315681,296133587,216133587,270.16698375,"Action,Drama,War",7.6,134.0
69,"Sep 28, 2018",Smallfoot,80000000,83240103,213691277,296931380,216931380,271.164225,"Adventure,Animation,Comedy",6.7,96.0
71,"Jul 8, 2011",Zookeeper,80000000,80360866,170805525,251166391,171166391,213.95798875,"Comedy,Family,Romance",5.2,102.0
73,"Aug 8, 1997",Conspiracy Theory,80000000,76118990,142783718,218902708,138902708,173.628385,"Horror,Thriller",5.8,79.0
81,"Jun 7, 2019",The Secret Life of Pets 2,80000000,63795655,113351496,177147151,97147151,121.43393875,"Adventure,Animation,Comedy",6.6,86.0
89,"Jun 8, 2001",Evolution,80000000,38311134,98341932,136653066,56653066,70.8163325,"Drama,Mystery,Sci-Fi",6.0,81.0
95,"Dec 6, 1996",Daylight,80000000,32908290,158908290,191816580,111816580,139.770725,"Crime,Horror,Thriller",5.1,75.0
95,"Dec 6, 1996",Daylight,80000000,32908290,158908290,191816580,111816580,139.770725,"Drama,Mystery,Thriller",7.0,114.0
95,"Dec 6, 1996",Daylight,80000000,32908290,158908290,191816580,111816580,139.770725,"Drama,Horror,Mystery",4.1,97.0
96,"Oct 23, 2015",The Last Witch Hunter,80000000,27367660,130818912,158186572,78186572,97.733215,"Action,Adventure,Fantasy",6.0,106.0
97,"Feb 21, 2014",Pompeii,80000000,23169033,108469033,131638066,51638066,64.5475825,"Action,Adventure,Drama",5.5,105.0
1,"Nov 26, 2003",Timeline,80000000,19480739,26703184,46183923,-33816077,-42.27009625,Romance,6.9,135.0
10,"Feb 10, 2012",Journey 2: The Mysterious Island,79000000,103860290,318146162,422006452,343006452,434.18538227848103,"Action,Adventure,Comedy",5.8,94.0
11,"Nov 11, 2011",Jack and Jill,79000000,74158157,150519217,224677374,145677374,184.40173924050634,Comedy,3.3,91.0
13,"Sep 27, 2013",Cloudy with a Chance of Meatballs 2,78000000,119793567,274392649,394186216,316186216,405.3669435897436,"Adventure,Animation,Comedy",6.4,95.0
19,"Feb 12, 2016",The Little Prince,77500000,1311213,102028919,103340132,25840132,33.34210580645161,Action,8.3,93.0
19,"Feb 12, 2016",The Little Prince,77500000,1311213,102028919,103340132,25840132,33.34210580645161,"Adventure,Animation,Drama",7.7,108.0
21,"Jul 20, 2018",The Equalizer 2,77000000,102084362,190453132,292537494,215537494,279.9188233766234,"Action,Crime,Thriller",6.7,121.0
22,"Jul 3, 2013",Despicable Me 2,76000000,368065385,975216835,1343282220,1267282220,1667.4766052631578,"Adventure,Animation,Comedy",7.4,98.0
26,"Jul 8, 2016",The Secret Life of Pets,75000000,368384330,886750534,1255134864,1180134864,1573.513152,"Adventure,Animation,Comedy",6.5,87.0
29,"Dec 21, 2016",Sing,75000000,270329045,634454789,904783834,829783834,1106.3784453333333,"Animation,Comedy,Family",7.1,108.0
30,"Jun 30, 2017",Despicable Me 3,75000000,264624300,1034727750,1299352050,1224352050,1632.4694000000002,"Adventure,Animation,Comedy",6.3,89.0
34,"Jun 25, 2010",Grown Ups,75000000,162001186,272223430,434224616,359224616,478.9661546666666,Comedy,6.0,102.0
37,"Jun 27, 2008",Wanted,75000000,134508551,342416460,476925011,401925011,535.9000146666666,Action,6.3,110.0
37,"Jun 27, 2008",Wanted,75000000,134508551,342416460,476925011,401925011,535.9000146666666,"Action,Drama",4.5,160.0
38,"Jun 7, 1996",The Rock,75000000,134069511,336069511,470139022,395139022,526.8520293333333,Comedy,8.7,70.0
41,"May 31, 2013",Now You See Me,75000000,117723989,342769200,460493189,385493189,513.9909186666666,"Crime,Mystery,Thriller",7.3,115.0
41,"May 31, 2013",Now You See Me,75000000,117723989,342769200,460493189,385493189,513.9909186666666,"Drama,Horror,Thriller",7.0,98.0
43,"Aug 3, 2018",Christopher Robin,75000000,99215042,197504758,296719800,221719800,295.6264,"Adventure,Animation,Comedy",7.3,104.0
45,"Nov 11, 2011",Immortals,75000000,83504017,211562435,295066452,220066452,293.421936,"Action,Drama,Fantasy",6.0,110.0
51,"Apr 16, 1999",Life,75000000,64062587,73521587,137584174,62584174,83.44556533333333,Documentary,7.8,75.0
51,"Apr 16, 1999",Life,75000000,64062587,73521587,137584174,62584174,83.44556533333333,"Biography,Drama",6.1,111.0
51,"Apr 16, 1999",Life,75000000,64062587,73521587,137584174,62584174,83.44556533333333,"Horror,Sci-Fi,Thriller",6.6,104.0
54,"Jun 4, 2010",Killers,75000000,47059963,95572749,142632712,67632712,90.17694933333334,"Action,Comedy,Romance",5.4,100.0
54,"Jun 4, 2010",Killers,75000000,47059963,95572749,142632712,67632712,90.17694933333334,"Action,Crime,Drama",6.5,137.0
62,"Mar 25, 2011",Sucker Punch,75000000,36392502,89758389,126150891,51150891,68.201188,"Action,Adventure,Fantasy",6.1,110.0
63,"Mar 11, 2005",Hostage,75000000,34636443,77636443,112272886,37272886,49.69718133333333,Thriller,5.7,91.0
63,"Mar 11, 2005",Hostage,75000000,34636443,77636443,112272886,37272886,49.69718133333333,"Comedy,Drama,History",6.3,97.0
64,"Oct 28, 2016",Inferno,75000000,34343574,219519367,253862941,178862941,238.4839213333333,Thriller,6.3,100.0
64,"Oct 28, 2016",Inferno,75000000,34343574,219519367,253862941,178862941,238.4839213333333,"Action,Adventure,Crime",6.2,121.0
64,"Oct 28, 2016",Inferno,75000000,34343574,219519367,253862941,178862941,238.4839213333333,Drama,6.3,113.0
69,"Jan 15, 1999",Virus,75000000,14010690,30626690,44637380,-30362620,-40.48349333333333,"Drama,Thriller",8.6,152.0
73,"Jul 10, 2015",Minions,74000000,336045770,1160336173,1496381943,1422381943,1922.1377608108107,"Adventure,Animation,Comedy",6.4,91.0
74,"Feb 6, 2015",The SpongeBob Movie: Sponge Out of Water,74000000,162994032,311013181,474007213,400007213,540.5502878378378,"Adventure,Animation,Comedy",6.0,92.0
75,"Nov 22, 2000",Unbreakable,73243106,94999143,248099143,343098286,269855180,368.43765200236044,"Adventure,Biography,Documentary",7.2,80.0
77,"May 20, 2016",The Angry Birds Movie,73000000,107509366,352327887,459837253,386837253,529.9140452054795,"Action,Animation,Comedy",6.3,97.0
87,"Apr 27, 2001",Driven,72000000,32616869,54616869,87233738,15233738,21.157969444444443,"Biography,Drama,Thriller",6.6,108.0
8,"Jun 13, 1997",Hercules,70000000,99112101,250700000,349812101,279812101,399.73157285714285,"Action,Adventure,Fantasy",6.0,98.0
8,"Jun 13, 1997",Hercules,70000000,99112101,250700000,349812101,279812101,399.73157285714285,Comedy,6.2,112.0
9,"Mar 22, 2013",Olympus Has Fallen,70000000,98927592,172878928,271806520,201806520,288.2950285714286,"Action,Thriller",6.5,119.0
12,"Dec 25, 2011",War Horse,70000000,79883359,156815529,236698888,166698888,238.14126857142858,"Drama,History,War",7.2,146.0
14,"Feb 7, 2014",The Monuments Men,70000000,78031620,158702748,236734368,166734368,238.19195428571427,"Comedy,Drama,History",6.1,118.0
15,"Sep 23, 2016",Storks,70000000,72679278,183353431,256032709,186032709,265.7610128571429,"Adventure,Animation,Comedy",6.8,87.0
17,"Dec 10, 2003",Big Fish,70000000,66432867,123954323,190387190,120387190,171.9817,Action,4.0,103.0
18,"Jun 17, 1994",Wolf,70000000,65011757,131011757,196023514,126023514,180.0335914285714,"Action,Crime,Drama",4.7,98.0
18,"Jun 17, 1994",Wolf,70000000,65011757,131011757,196023514,126023514,180.0335914285714,"Drama,Family",6.9,87.0
18,"Jun 17, 1994",Wolf,70000000,65011757,131011757,196023514,126023514,180.0335914285714,"Crime,Drama,Thriller",7.3,122.0
18,"Jun 17, 1994",Wolf,70000000,65011757,131011757,196023514,126023514,180.0335914285714,Drama,4.1,85.0
18,"Jun 17, 1994",Wolf,70000000,65011757,131011757,196023514,126023514,180.0335914285714,"Action,Thriller,War",7.3,80.0
20,"Sep 22, 2017",The Lego Ninjago Movie,70000000,59281555,122737201,182018756,112018756,160.0267942857143,"Action,Adventure,Animation",6.0,101.0
21,"Oct 10, 2014",Dracula Untold,70000000,55991880,220241723,276233603,206233603,294.61943285714284,"Action,Drama,Fantasy",6.3,92.0
22,"Sep 29, 2006",The Guardian,70000000,55011732,94973540,149985272,79985272,114.26467428571429,"Action,Mystery,Sci-Fi",6.7,72.0
22,"Sep 29, 2006",The Guardian,70000000,55011732,94973540,149985272,79985272,114.26467428571429,"Action,Animation,Fantasy",7.1,93.0
25,"Jan 14, 2011",The Dilemma,70000000,48475290,70546865,119022155,49022155,70.03165,"Comedy,Drama",5.3,111.0
27,"Nov 6, 1998",The Siege,70000000,40934175,116625798,157559973,87559973,125.0856757142857,Documentary,7.2,88.0
29,"Jun 15, 2012",Rock of Ages,70000000,38518613,61031932,99550545,29550545,42.21506428571429,"Comedy,Drama,Musical",5.9,123.0
34,"Jun 7, 2002",Bad Company,70000000,30157016,69157016,99314032,29314032,41.87718857142857,Thriller,5.1,87.0
34,"Jun 7, 2002",Bad Company,70000000,30157016,69157016,99314032,29314032,41.87718857142857,Action,3.3,90.0
36,"Jan 29, 2016",The Finest Hours,70000000,27569558,49252761,76822319,6822319,9.74617,"Action,Drama,History",6.8,117.0
37,"Oct 18, 2013",Escape Plan,70000000,25135965,103735965,128871930,58871930,84.10275714285714,"Action,Crime,Mystery",6.7,115.0
38,"Sep 23, 2011",Killer Elite,70000000,25124986,65409046,90534032,20534032,29.33433142857143,"Action,Crime,Thriller",6.5,116.0
42,"Jan 10, 2014",The Legend of Hercules,70000000,18848538,58953319,77801857,7801857,11.14551,"Action,Adventure,Fantasy",4.2,99.0
43,"Apr 27, 2007",Next,70000000,18211013,73591500,91802513,21802513,31.14644714285714,Documentary,8.0,72.0
47,"Jan 16, 2015",Blackhat,70000000,8005980,19665004,27670984,-42329016,-60.47002285714286,"Action,Crime,Thriller",5.4,133.0
50,"Jul 9, 2010",Despicable Me,69000000,251513985,543464573,794978558,725978558,1052.1428376811593,"Animation,Comedy,Family",7.7,95.0
51,"Jul 30, 2010",Dinner for Schmucks,69000000,73026337,86796502,159822839,90822839,131.62730289855074,Comedy,5.9,114.0
52,"Mar 2, 2018",Red Sparrow,69000000,46874505,145951861,192826366,123826366,179.45850144927536,"Action,Drama,Thriller",6.6,140.0
53,"Jun 30, 2010",The Twilight Saga: Eclipse,68000000,300531751,706102828,1006634579,938634579,1380.3449691176472,"Adventure,Drama,Fantasy",5.0,124.0
55,"Jun 26, 2015",Ted 2,68000000,81476385,217214143,298690528,230690528,339.2507764705882,Comedy,6.3,115.0
57,"Feb 25, 2011",Hall Pass,68000000,45060734,87173475,132234209,64234209,94.46207205882354,"Comedy,Romance",5.9,105.0
59,"Mar 21, 2003",Dreamcatcher,68000000,33685268,75685268,109370536,41370536,60.83902352941176,"Crime,Documentary,Drama",7.1,104.0
62,"Dec 22, 2017",Downsizing,68000000,24449754,54462971,78912725,10912725,16.048125,"Drama,Sci-Fi",5.7,135.0
65,"Jun 22, 2012",Abraham Lincoln: Vampire Hunter,67500000,37519139,137489730,175008869,107508869,159.27239851851851,"Action,Fantasy,Horror",5.9,105.0
66,"Sep 20, 1996",Last Man Standing,67000000,18115927,18115927,36231854,-30768146,-45.922605970149256,"Biography,Crime,Documentary",5.2,85.0
70,"Mar 14, 2014",Need for Speed,66000000,43568507,194169619,237738126,171738126,260.2092818181818,"Action,Crime,Thriller",6.5,132.0
72,"Dec 15, 2000",What Women Want,65000000,182805123,374105123,556910246,491910246,756.7849938461538,"Comedy,Romance,Sci-Fi",5.6,116.0
73,"Nov 9, 2012",Lincoln,65000000,182207973,273346281,455554254,390554254,600.8526984615385,"Biography,Drama,History",7.4,150.0
74,"Mar 15, 2002",Ice Age,65000000,176387405,386116343,562503748,497503748,765.3903815384615,"Crime,Drama,Family",6.2,106.0
77,"Jul 13, 2018",Hotel Transylvania 3: Summer Vacation,65000000,167500092,527079962,694580054,629580054,968.5846984615384,"Adventure,Animation,Comedy",6.3,97.0
80,"Jun 1, 1990",Total Recall,65000000,119394839,261400000,380794839,315794839,485.8382138461539,"Action,Adventure,Mystery",6.3,118.0
82,"Dec 25, 2014",Unbroken,65000000,115637895,163527824,279165719,214165719,329.4857215384615,"Biography,Drama,Sport",7.2,137.0
84,"Nov 5, 2010",Due Date,65000000,100539043,211739043,312278086,247278086,380.4278246153846,"Adventure,Comedy",6.5,95.0
89,"Dec 19, 2014",Annie,65000000,85911262,139829625,225740887,160740887,247.2936723076923,"Comedy,Drama,Family",5.3,118.0
94,"Jul 7, 2000",The Kid,65000000,69688384,69688384,139376768,74376768,114.42579692307693,Drama,6.9,111.0
94,"Jul 7, 2000",The Kid,65000000,69688384,69688384,139376768,74376768,114.42579692307693,"Comedy,Drama,Family",6.4,49.0
94,"Jul 7, 2000",The Kid,65000000,69688384,69688384,139376768,74376768,114.42579692307693,"Biography,Drama,Western",6.0,100.0
96,"May 16, 2012",The Dictator,65000000,59650222,180148897,239799119,174799119,268.9217215384615,Comedy,6.4,83.0
98,"Feb 17, 2012",This Means War,65000000,54760791,156974557,211735348,146735348,225.74668923076922,"Action,Comedy,Romance",6.3,103.0
99,"Feb 27, 2015",Focus,65000000,53862963,168065700,221928663,156928663,241.4287123076923,"Comedy,Crime,Drama",6.6,105.0
99,"Feb 27, 2015",Focus,65000000,53862963,168065700,221928663,156928663,241.4287123076923,Comedy,6.8,87.0
1,"Nov 21, 2012",Red Dawn,65000000,44806783,48164150,92970933,27970933,43.032204615384614,"Action,Sci-Fi,Thriller",5.4,93.0
3,"Sep 18, 2015",Everest,65000000,43482270,221297061,264779331,199779331,307.35281692307694,"Action,Adventure,Biography",7.1,121.0
4,"Sep 14, 2012",Resident Evil: Retribution,65000000,42345531,240647629,282993160,217993160,335.3740923076923,"Action,Horror,Sci-Fi",5.4,95.0
11,"Nov 26, 2003",The Missing,65000000,26900336,38253433,65153769,153769,0.2365676923076923,"Action,Crime,Thriller",5.2,95.0
14,"Jan 24, 2014","I, Frankenstein",65000000,19075290,74575290,93650580,28650580,44.077815384615384,"Action,Fantasy,Horror",5.1,92.0
16,"Aug 22, 2014",Sin City: A Dame to Kill For,65000000,13757804,40650842,54408646,-10591354,-16.29439076923077,"Crime,Thriller",6.5,102.0
17,"Dec 25, 2016",Live by Night,65000000,10378555,21774432,32152987,-32847013,-50.533866153846155,"Action,Crime,Drama",6.4,129.0
21,"Oct 26, 2018",Air Strike,65000000,0,516279,516279,-64483721,-99.20572461538461,"Action,Adventure,Drama",3.3,120.0
27,"Apr 1, 2011",Hop,63000000,108085305,188657593,296742898,233742898,371.020473015873,"Adventure,Animation,Comedy",5.4,95.0
28,"Sep 15, 2017",American Assassin,63000000,36249674,68310140,104559814,41559814,65.96795873015873,"Action,Thriller",6.2,112.0
33,"Dec 25, 2015",The Hateful Eight,62000000,54117416,147864886,201982302,139982302,225.77790645161292,"Crime,Drama,Mystery",7.8,168.0
36,"Oct 3, 2014",Gone Girl,61000000,167767189,368567189,536334378,475334378,779.2366852459016,"Drama,Mystery,Thriller",8.1,149.0
38,"Sep 18, 2015",Maze Runner: The Scorch Trials,61000000,81697192,310566162,392263354,331263354,543.0546786885245,"Action,Sci-Fi,Thriller",6.3,131.0
39,"Aug 2, 2013",2 Guns,61000000,75612460,132493015,208105475,147105475,241.15651639344264,"Action,Comedy,Crime",6.7,109.0
44,"Feb 7, 2014",The Lego Movie,60000000,257784718,457729388,715514106,655514106,1092.52351,"Action,Adventure,Animation",7.8,100.0
50,"Sep 9, 2016",Sully,60000000,125070033,238524556,363594589,303594589,505.9909816666667,"Biography,Drama",7.5,96.0
63,"Oct 15, 2010",Red,60000000,90380162,196439693,286819855,226819855,378.0330916666667,Drama,8.4,107.0
63,"Oct 15, 2010",Red,60000000,90380162,196439693,286819855,226819855,378.0330916666667,Drama,8.1,90.0
67,"Aug 13, 2010",Eat Pray Love,60000000,80574010,206598789,287172799,227172799,378.62133166666666,"Drama,Romance",5.8,133.0
68,"Dec 21, 2012",Jack Reacher,60000000,80070736,217370736,297441472,237441472,395.7357866666666,"Action,Crime,Thriller",7.0,130.0
71,"Sep 9, 2011",Contagion,60000000,75658097,137551594,213209691,153209691,255.349485,"Action,Drama,Thriller",6.6,106.0
80,"Mar 4, 2016",London Has Fallen,60000000,62524260,195194085,257718345,197718345,329.530575,"Action,Thriller",5.9,99.0
84,"Apr 2, 2004",Hellboy,60000000,59623958,99823958,159447916,99447916,165.74652666666668,"Action,Adventure,Fantasy",5.4,120.0
85,"Oct 21, 2016",Jack Reacher: Never Go Back,60000000,58697076,159946489,218643565,158643565,264.4059416666667,"Action,Thriller",6.1,118.0
86,"May 25, 2017",Baywatch,60000000,58060186,175863783,233923969,173923969,289.8732816666667,"Action,Comedy,Crime",5.6,116.0
88,"Dec 25, 2015",Joy,60000000,56451232,101134059,157585291,97585291,162.64215166666668,Drama,6.1,75.0
88,"Dec 25, 2015",Joy,60000000,56451232,101134059,157585291,97585291,162.64215166666668,Drama,6.6,124.0
88,"Dec 25, 2015",Joy,60000000,56451232,101134059,157585291,97585291,162.64215166666668,Drama,7.1,80.0
88,"Dec 25, 2015",Joy,60000000,56451232,101134059,157585291,97585291,162.64215166666668,Drama,6.5,99.0
89,"Aug 17, 2012",ParaNorman,60000000,56003051,108119662,164122713,104122713,173.537855,"Adventure,Animation,Comedy",7.0,92.0
94,"Sep 26, 2014",The Boxtrolls,60000000,50837305,111946251,162783556,102783556,171.30592666666666,"Adventure,Animation,Comedy",6.8,96.0
95,"Aug 4, 2017",The Dark Tower,60000000,50701325,113461527,164162852,104162852,173.60475333333335,"Action,Adventure,Fantasy",5.7,95.0
97,"Jan 17, 2014",Jack Ryan: Shadow Recruit,60000000,50577412,131377412,181954824,121954824,203.25804,"Action,Drama,Thriller",6.2,105.0
100,"Dec 25, 2018",Vice,60000000,47836282,70883171,118719453,58719453,97.865755,"Action,Adventure,Sci-Fi",4.2,96.0
100,"Dec 25, 2018",Vice,60000000,47836282,70883171,118719453,58719453,97.865755,"Biography,Comedy,Drama",7.2,132.0
4,"Jan 11, 2013",Gangster Squad,60000000,46000903,104100903,150101806,90101806,150.16967666666667,"Action,Crime,Drama",6.7,113.0
5,"Apr 7, 2017",Smurfs: The Lost Village,60000000,45020282,197578586,242598868,182598868,304.3314466666667,"Adventure,Animation,Comedy",6.0,90.0
6,"Oct 12, 2018",First Man,60000000,44936545,105203825,150140370,90140370,150.23395,"Biography,Drama,History",7.4,141.0
6,"Oct 12, 2018",First Man,60000000,44936545,105203825,150140370,90140370,150.23395,Documentary,6.6,92.0
8,"Jan 29, 2010",Edge of Darkness,60000000,43313890,82812456,126126346,66126346,110.21057666666667,"Crime,Drama,Mystery",6.6,117.0
12,"Mar 20, 2009",Duplicity,60000000,40572825,81079566,121652391,61652391,102.75398499999999,Mystery,8.1,71.0
15,"Apr 17, 2009",State of Play,60000000,37017955,88832210,125850165,65850165,109.750275,"Documentary,Drama,Sport",6.5,87.0
18,"Sep 21, 2012",Trouble with the Curve,60000000,35763137,47818913,83582050,23582050,39.30341666666667,"Drama,Sport",6.8,111.0
22,"Sep 15, 2000",Almost Famous,60000000,32522352,47371191,79893543,19893543,33.155905000000004,"Comedy,Drama,Family",4.1,95.0
23,"Feb 8, 2019",Cold Pursuit,60000000,32138862,62599159,94738021,34738021,57.89670166666666,"Action,Crime,Drama",6.2,119.0
26,"Aug 21, 2013",The Mortal Instruments: City of Bones,60000000,31165421,75965567,107130988,47130988,78.55164666666667,"Action,Fantasy,Horror",5.9,130.0
28,"Feb 22, 2002",Dragonfly,60000000,30063805,30063805,60127610,127610,0.21268333333333334,"Crime,Drama,Thriller",6.3,80.0
28,"Feb 22, 2002",Dragonfly,60000000,30063805,30063805,60127610,127610,0.21268333333333334,"Action,Adventure,Sci-Fi",9.0,75.0
28,"Feb 22, 2002",Dragonfly,60000000,30063805,30063805,60127610,127610,0.21268333333333334,Drama,4.8,76.0
29,"May 13, 2011",Priest,60000000,29136626,84154026,113290652,53290652,88.81775333333334,"Action,Adventure,Fantasy",5.7,87.0
35,"Aug 14, 1998",The Avengers,60000000,23385416,48585416,71970832,11970832,19.951386666666668,"Action,Adventure,Sci-Fi",8.1,143.0
41,"Jan 14, 2000",Supernova,60000000,14218868,14816494,29035362,-30964638,-51.60773,Drama,5.7,90.0
41,"Jan 14, 2000",Supernova,60000000,14218868,14816494,29035362,-30964638,-51.60773,"Drama,Mystery,Sci-Fi",6.6,135.0
47,"Feb 24, 2017",Rock Dog,60000000,9420546,24148488,33569034,-26430966,-44.051610000000004,"Adventure,Animation,Comedy",5.9,90.0
48,"Jan 23, 2015",Mortdecai,60000000,7696134,30396134,38092268,-21907732,-36.51288666666667,"Action,Comedy,Crime",5.5,107.0
52,"Dec 11, 2015",The Ridiculous 6,60000000,0,0,0,-60000000,-100.0,"Comedy,Western",4.8,119.0
53,"Nov 8, 2019",Midway,59500000,0,0,0,-59500000,-100.0,"Documentary,Family",7.3,85.0
54,"Mar 23, 2018",Sherlock Gnomes,59000000,43242871,87527651,130770522,71770522,121.64495254237289,"Adventure,Animation,Comedy",5.1,86.0
55,"Jan 25, 2019",The Kid Who Would Be King,59000000,16790790,28348446,45139236,-13860764,-23.49282033898305,"Action,Adventure,Family",6.0,120.0
56,"Feb 12, 2016",Deadpool,58000000,363070709,801025593,1164096302,1106096302,1907.0625896551726,"Action,Adventure,Comedy",8.0,108.0
57,"Dec 25, 2014",American Sniper,58000000,350126372,547326372,897452744,839452744,1447.3323172413793,"Action,Biography,Drama",7.3,133.0
58,"Oct 16, 2015",Goosebumps,58000000,80069458,158905324,238974782,180974782,312.0254862068966,"Adventure,Comedy,Family",6.3,103.0
60,"Dec 15, 1995",Sabrina,58000000,53458319,87100000,140558319,82558319,142.34192931034482,"Horror,Thriller",4.3,113.0
61,"Jan 20, 2012",Red Tails,58000000,49876377,50365498,100241875,42241875,72.83081896551724,"Action,Adventure,Drama",5.9,125.0
63,"Jun 7, 2013",The Internship,58000000,44672764,93672764,138345528,80345528,138.5267724137931,Comedy,6.3,119.0
66,"Mar 24, 2017",Life,58000000,30234022,100929666,131163688,73163688,126.14428965517241,Documentary,7.8,75.0
66,"Mar 24, 2017",Life,58000000,30234022,100929666,131163688,73163688,126.14428965517241,"Biography,Drama",6.1,111.0
66,"Mar 24, 2017",Life,58000000,30234022,100929666,131163688,73163688,126.14428965517241,"Horror,Sci-Fi,Thriller",6.6,104.0
70,"Sep 10, 2010",Resident Evil: Afterlife,57500000,60128566,295874190,356002756,298502756,519.135227826087,"Action,Adventure,Horror",5.9,96.0
71,"Jun 15, 2012",That's My Boy,57500000,36931089,58085235,95016324,37516324,65.24578086956522,Comedy,5.6,116.0
73,"Feb 17, 2012",Ghost Rider: Spirit of Vengeance,57000000,51774002,149217355,200991357,143991357,252.6164157894737,"Action,Fantasy,Thriller",4.3,96.0
77,"Dec 25, 2014",Into the Woods,56200000,128002372,213116401,341118773,284918773,506.97290569395017,"Adventure,Comedy,Drama",6.0,125.0
84,"Nov 2, 2018",Bohemian Rhapsody,55000000,216303339,894985342,1111288681,1056288681,1920.5248745454546,"Biography,Drama,Music",8.0,134.0
85,"Feb 11, 2005",Hitch,55000000,177784257,366784257,544568514,489568514,890.124570909091,Drama,7.4,70.0
91,"Feb 10, 2017",Fifty Shades Darker,55000000,114434010,381398492,495832502,440832502,801.5136399999999,"Drama,Romance",4.6,118.0
92,"Oct 11, 2013",Captain Phillips,55000000,107136417,220648184,327784601,272784601,495.97200181818187,"Biography,Drama,Thriller",7.8,134.0
95,"Nov 10, 2017",Murder on the Orient Express,55000000,102826543,345922730,448749273,393749273,715.907769090909,"Crime,Drama,Mystery",6.5,114.0
96,"Sep 26, 2014",The Equalizer,55000000,101530738,192903624,294434362,239434362,435.33520363636364,"Action,Crime,Thriller",7.2,132.0
97,"Feb 9, 2018",Fifty Shades Freed,55000000,100407760,371350619,471758379,416758379,757.7425072727273,"Drama,Romance,Thriller",4.5,105.0
99,"Apr 9, 2010",Date Night,55000000,98711404,152269033,250980437,195980437,356.32806727272725,"Comedy,Crime,Romance",6.3,88.0
5,"Jan 16, 2015",Paddington,55000000,76223578,258789097,335012675,280012675,509.1139545454546,"Adventure,Comedy,Family",7.2,95.0
16,"Nov 1, 2013",Free Birds,55000000,55750480,110387072,166137552,111137552,202.0682763636364,"Adventure,Animation,Comedy",5.9,91.0
20,"Mar 21, 2014",Muppets Most Wanted,55000000,51178893,79312301,130491194,75491194,137.25671636363637,"Adventure,Comedy,Crime",6.4,107.0
22,"Aug 19, 2016",Kubo and the Two Strings,55000000,48023088,77548122,125571210,70571210,128.3112909090909,"Action,Adventure,Animation",7.8,101.0
24,"Nov 24, 2010",Burlesque,55000000,39440655,90552675,129993330,74993330,136.3515090909091,"Drama,Music,Musical",6.4,119.0
27,"Jul 27, 2012",The Watch,55000000,34353000,67130045,101483045,46483045,84.51462727272727,"Action,Comedy,Horror",5.7,102.0
28,"Mar 14, 2003",The Hunted,55000000,34234008,47213095,81447103,26447103,48.08564181818182,"Action,Comedy,Horror",6.5,90.0
28,"Mar 14, 2003",The Hunted,55000000,34234008,47213095,81447103,26447103,48.08564181818182,"Horror,Mystery,Thriller",4.7,89.0
32,"Feb 23, 2018",Annihilation,55000000,32732301,43070915,75803216,20803216,37.824029090909086,"Adventure,Drama,Horror",6.9,115.0
33,"Oct 16, 2015",Crimson Peak,55000000,31090320,74966854,106057174,51057174,92.83122545454545,"Drama,Fantasy,Horror",6.5,119.0
34,"Apr 27, 2012",The Pirates! Band of Misfits,55000000,31051126,136143605,167194731,112194731,203.99042,"Adventure,Animation,Comedy",6.7,88.0
36,"Aug 2, 1996",Chain Reaction,55000000,21226204,60209334,81435538,26435538,48.064614545454546,Drama,3.4,100.0
41,"Jan 10, 1997",Turbulence,55000000,11532774,11532774,23065548,-31934452,-58.06264,Comedy,8.2,90.0
41,"Jan 10, 1997",Turbulence,55000000,11532774,11532774,23065548,-31934452,-58.06264,Drama,6.8,90.0
41,"Jan 10, 1997",Turbulence,55000000,11532774,11532774,23065548,-31934452,-58.06264,"Action,Drama,Thriller",5.3,120.0
42,"Feb 1, 2013",Bullet to the Head,55000000,9489829,22597969,32087798,-22912202,-41.65854909090909,"Action,Crime,Thriller",5.7,92.0
59,"Sep 18, 2015",Black Mass,53000000,62575678,98837872,161413550,108413550,204.55386792452833,"Biography,Crime,Drama",6.9,123.0
65,"Oct 16, 1998",Beloved,53000000,22852487,22852487,45704974,-7295026,-13.764199999999999,Comedy,6.4,107.0
65,"Oct 16, 1998",Beloved,53000000,22852487,22852487,45704974,-7295026,-13.764199999999999,"Drama,Musical,Romance",6.2,133.0
65,"Oct 16, 1998",Beloved,53000000,22852487,22852487,45704974,-7295026,-13.764199999999999,Drama,6.7,99.0
65,"Oct 16, 1998",Beloved,53000000,22852487,22852487,45704974,-7295026,-13.764199999999999,Documentary,7.3,66.0
66,"Dec 19, 2012",Zero Dark Thirty,52500000,95720716,134612435,230333151,177833151,338.7298114285714,"Drama,Thriller",7.4,157.0
70,"Feb 12, 2010",Valentine's Day,52000000,110485654,217569328,328054982,276054982,530.8749653846154,"Comedy,Romance",5.7,125.0
72,"Aug 5, 2011",The Change-Up,52000000,37243418,75997067,113240485,61240485,117.77016346153846,"Comedy,Fantasy",6.3,112.0
79,"Aug 17, 2018",Alpha,51000000,35851379,99624873,135476252,84476252,165.63970980392156,Crime,5.5,116.0
79,"Aug 17, 2018",Alpha,51000000,35851379,99624873,135476252,84476252,165.63970980392156,"Drama,Horror,Mystery",7.7,80.0
79,"Aug 17, 2018",Alpha,51000000,35851379,99624873,135476252,84476252,165.63970980392156,"Adventure,Drama,Family",6.7,96.0
81,"Mar 4, 2011",The Adjustment Bureau,50200000,62495645,126931325,189426970,139226970,277.34456175298806,"Romance,Sci-Fi,Thriller",7.1,106.0
84,"Jun 29, 2012",Ted,50000000,218665740,556016627,774682367,724682367,1449.364734,"Comedy,Fantasy",6.9,106.0
85,"Jun 13, 2014",22 Jump Street,50000000,191719337,331333876,523053213,473053213,946.106426,"Action,Comedy,Crime",7.0,112.0
91,"Jun 17, 2016",Central Intelligence,50000000,127440871,217194805,344635676,294635676,589.271352,"Action,Comedy,Crime",6.3,107.0
92,"Dec 18, 2013",Anchorman 2: The Legend Continues,50000000,127352707,172185754,299538461,249538461,499.07692199999997,Comedy,6.3,119.0
93,"Jun 10, 2011",Super 8,50000000,127004179,257972745,384976924,334976924,669.953848,"Mystery,Sci-Fi,Thriller",7.0,112.0
96,"Nov 21, 2018",Creed II,50000000,115715889,213591522,329307411,279307411,558.614822,"Drama,Sport",7.2,130.0
97,"Feb 9, 2018",Peter Rabbit,50000000,115234093,347136477,462370570,412370570,824.7411400000001,"Adventure,Animation,Comedy",6.6,95.0
100,"Dec 14, 2018",The Mule,50000000,103804407,170857676,274662083,224662083,449.324166,"Comedy,Drama",6.2,100.0
100,"Dec 14, 2018",The Mule,50000000,103804407,170857676,274662083,224662083,449.324166,"Comedy,Crime,Drama",6.3,103.0
100,"Dec 14, 2018",The Mule,50000000,103804407,170857676,274662083,224662083,449.324166,"Crime,Drama,Thriller",7.1,116.0
2,"Feb 28, 2014",Non-Stop,50000000,91742160,222383055,314125215,264125215,528.25043,"Action,Mystery,Thriller",7.0,106.0
7,"Jul 28, 2017",The Emoji Movie,50000000,86089513,216562312,302651825,252651825,505.30365,"Adventure,Animation,Comedy",3.2,86.0
9,"Dec 22, 2017",The Post,50000000,81903458,179748880,261652338,211652338,423.304676,"Biography,Drama,History",7.2,116.0
10,"Feb 5, 1999",Payback,50000000,81526121,161626121,243152242,193152242,386.304484,Documentary,6.4,82.0
10,"Feb 5, 1999",Payback,50000000,81526121,161626121,243152242,193152242,386.304484,"Action,Crime,Drama",5.5,115.0
10,"Feb 5, 1999",Payback,50000000,81526121,161626121,243152242,193152242,386.304484,"Action,Comedy,Drama",5.0,77.0
14,"Dec 23, 2011",We Bought a Zoo,50000000,75624550,118729073,194353623,144353623,288.707246,"Comedy,Drama,Family",7.1,124.0
15,"Sep 23, 2011",Moneyball,50000000,75605492,111300835,186906327,136906327,273.812654,"Biography,Drama,Sport",7.6,133.0
21,"Sep 24, 2004",The Forgotten,50000000,66711892,117211892,183923784,133923784,267.847568,Horror,5.3,89.0
26,"Apr 6, 2012",American Reunion,50000000,56758835,236799211,293558046,243558046,487.11609200000004,Comedy,6.7,113.0
27,"Jan 25, 2013",Hansel & Gretel: Witch Hunters,50000000,55703475,214949716,270653191,220653191,441.306382,"Action,Fantasy,Horror",6.1,88.0
32,"Sep 29, 2017",American Made,50000000,51342000,135569212,186911212,136911212,273.822424,"Action,Biography,Comedy",7.2,115.0
35,"Oct 17, 2014",The Book of Life,50000000,50151543,97651543,147803086,97803086,195.606172,"Adventure,Animation,Comedy",7.3,95.0
35,"Oct 17, 2014",The Book of Life,50000000,50151543,97651543,147803086,97803086,195.606172,Thriller,6.7,120.0
40,"Aug 8, 2014",Into the Storm,50000000,47602194,150429371,198031565,148031565,296.06313,"Action,Adventure,Drama",5.8,89.0
41,"Oct 10, 2014",The Judge,50000000,47119388,76119388,123238776,73238776,146.477552,"Crime,Drama",7.4,141.0
41,"Oct 10, 2014",The Judge,50000000,47119388,76119388,123238776,73238776,146.477552,Documentary,7.3,76.0
45,"Aug 19, 2016",War Dogs,50000000,43034523,86234503,129269026,79269026,158.538052,"Comedy,Crime,Drama",7.1,114.0
48,"Sep 26, 1997",The Peacemaker,50000000,41263140,62967368,104230508,54230508,108.461016,Documentary,7.9,90.0
56,"May 20, 2016",The Nice Guys,50000000,36261763,59596747,95858510,45858510,91.71702,"Action,Comedy,Crime",7.4,116.0
59,"Jun 4, 2010",Marmaduke,50000000,33644788,89895930,123540718,73540718,147.081436,"Comedy,Family",4.2,87.0
61,"Oct 15, 2010",Hereafter,50000000,32746941,108660270,141407211,91407211,182.814422,"Drama,Fantasy,Romance",6.5,129.0
63,"Oct 6, 1995",Assassins,50000000,30306268,83306268,113612536,63612536,127.225072,"Action,Drama,Thriller",4.4,84.0
64,"Feb 12, 2016",Zoolander 2,50000000,28848693,55348693,84197386,34197386,68.394772,Comedy,4.7,101.0
68,"Mar 29, 2013",The Host,50000000,26623701,64477051,91100752,41100752,82.201504,"Action,Adventure,Drama",5.9,125.0
68,"Mar 29, 2013",The Host,50000000,26623701,64477051,91100752,41100752,82.201504,Documentary,6.4,60.0
70,"Mar 13, 2015",Run All Night,50000000,26461644,66961644,93423288,43423288,86.846576,"Action,Drama,Thriller",6.6,114.0
77,"Apr 12, 2019",Hellboy,50000000,21903748,40725492,62629240,12629240,25.25848,"Action,Adventure,Fantasy",5.4,120.0
78,"Apr 8, 2011",Your Highness,50000000,21596445,26121638,47718083,-2281917,-4.563834,"Adventure,Comedy,Fantasy",5.5,102.0
79,"Sep 16, 2016",Snowden,50000000,21587519,35380918,56968437,6968437,13.936874,"Biography,Drama,Thriller",7.3,134.0
80,"Sep 30, 2011",Dream House,50000000,21302340,41642166,62944506,12944506,25.889012,"Drama,Mystery,Thriller",6.0,84.0
81,"Jun 24, 2016",Free State of Jones,50000000,20810036,23237252,44047288,-5952712,-11.905424,"Action,Biography,Drama",6.9,139.0
82,"Sep 4, 2009",Gamer,50000000,20534907,42002029,62536936,12536936,25.073872,Drama,5.0,92.0
85,"Feb 14, 2013",Beautiful Creatures,50000000,19452138,60282876,79735014,29735014,59.470028,"Drama,Fantasy,Romance",6.2,124.0
90,"Nov 3, 1995",Fair Game,50000000,11497497,26097497,37594994,-12405006,-24.810012,"Biography,Drama,Thriller",6.8,108.0
91,"Feb 25, 2011",Drive Angry,50000000,10721033,41042583,51763616,1763616,3.527232,"Action,Fantasy,Thriller",5.4,104.0
93,"Oct 13, 1995",The Scarlet Letter,50000000,10359006,10359006,20718012,-29281988,-58.563976,"Drama,History",6.1,111.0
94,"Oct 14, 2005",Domino,50000000,10169202,23574057,33743259,-16256741,-32.513481999999996,"Crime,Thriller",4.6,89.0
98,"Feb 16, 2018",Early Man,50000000,8267544,45285890,53553434,3553434,7.1068679999999995,"Adventure,Animation,Comedy",6.1,89.0
2,"Apr 17, 2015",Child 44,50000000,1224330,8004221,9228551,-40771449,-81.542898,"Crime,Drama,History",6.5,137.0
4,"Mar 15, 2013",Upside Down,50000000,102118,26387039,26489157,-23510843,-47.021686,"Drama,Fantasy,Romance",6.4,109.0
4,"Mar 15, 2013",Upside Down,50000000,102118,26387039,26489157,-23510843,-47.021686,Drama,6.6,81.0
5,"Oct 2, 2015",Shanghai,50000000,46425,15505922,15552347,-34447653,-68.895306,"Crime,Drama,Mystery",6.4,105.0
5,"Oct 2, 2015",Shanghai,50000000,46425,15505922,15552347,-34447653,-68.895306,"Crime,Mystery,Thriller",7.2,120.0
10,"Nov 2, 2001",The One,49000000,43905746,72689126,116594872,67594872,137.94871836734694,"Comedy,Drama,Romance",5.0,89.0
10,"Nov 2, 2001",The One,49000000,43905746,72689126,116594872,67594872,137.94871836734694,Comedy,5.4,116.0
11,"Mar 6, 2015",Chappie,49000000,31569268,105002056,136571324,87571324,178.71698775510202,"Action,Crime,Drama",6.8,120.0
13,"Nov 16, 2012",Anna Karenina,49000000,12816367,71004627,83820994,34820994,71.06325306122449,"Drama,Romance",6.6,129.0
16,"Dec 27, 2000",Traffic,48000000,124107476,208300000,332407476,284407476,592.515575,"Action,Adventure,Mystery",8.0,122.0
16,"Dec 27, 2000",Traffic,48000000,124107476,208300000,332407476,284407476,592.515575,"Adventure,Drama,Thriller",6.7,104.0
16,"Dec 27, 2000",Traffic,48000000,124107476,208300000,332407476,284407476,592.515575,Documentary,9.2,110.0
18,"Jan 9, 2015",Taken 3,48000000,89256424,327656424,416912848,368912848,768.5684333333334,"Action,Thriller",6.0,108.0
20,"Nov 16, 2018",Instant Family,48000000,67363237,119736188,187099425,139099425,289.79046875,"Comedy,Drama",7.4,118.0
22,"Oct 1, 1999",Three Kings,48000000,60652036,107752036,168404072,120404072,250.84181666666666,"Biography,Documentary,Sport",6.8,65.0
22,"Oct 1, 1999",Three Kings,48000000,60652036,107752036,168404072,120404072,250.84181666666666,Comedy,4.0,123.0
23,"Jan 22, 2010",Tooth Fairy,48000000,60022256,112610386,172632642,124632642,259.65133749999995,"Comedy,Family,Fantasy",5.0,101.0
23,"Jan 22, 2010",Tooth Fairy,48000000,60022256,112610386,172632642,124632642,259.65133749999995,Horror,2.6,86.0
31,"Jan 25, 2008",Rambo,47500000,42754105,112214531,154968636,107468636,226.24976,"Comedy,Drama,Thriller",6.3,144.0
32,"Jul 13, 2016",The Infiltrator,47500000,15436808,20718104,36154912,-11345088,-23.884395789473682,"Biography,Crime,Drama",7.0,127.0
34,"Nov 11, 2016",Arrival,47000000,100546139,203127894,303674033,256674033,546.1149638297873,"Drama,Mystery,Sci-Fi",7.9,116.0
36,"Apr 22, 2009",Earth,47000000,32011576,116773317,148784893,101784893,216.56360212765958,Sci-Fi,3.6,60.0
36,"Apr 22, 2009",Earth,47000000,32011576,116773317,148784893,101784893,216.56360212765958,Documentary,7.3,115.0
40,"Jun 18, 2010",Jonah Hex,47000000,10547117,11022696,21569813,-25430187,-54.10678085106383,"Action,Drama,Fantasy",4.7,81.0
42,"Dec 23, 2016",Silence,46500000,7100177,23726626,30826803,-15673197,-33.7058,"Adventure,Drama,History",7.2,161.0
42,"Dec 23, 2016",Silence,46500000,7100177,23726626,30826803,-15673197,-33.7058,"Drama,War",6.7,110.0
42,"Dec 23, 2016",Silence,46500000,7100177,23726626,30826803,-15673197,-33.7058,Drama,6.7,87.0
42,"Dec 23, 2016",Silence,46500000,7100177,23726626,30826803,-15673197,-33.7058,"Drama,Thriller",4.6,120.0
44,"Jun 20, 1997",My Best Friend's Wedding,46000000,126813153,298923419,425736572,379736572,825.5142869565217,"Comedy,Romance",5.0,91.0
48,"Sep 20, 2013",Prisoners,46000000,61002302,113402302,174404604,128404604,279.14044347826086,"Crime,Drama,Mystery",8.1,153.0
54,"Oct 5, 2012",Taken 2,45000000,139854287,377807404,517661691,472661691,1050.3593133333334,"Action,Thriller",6.3,92.0
58,"Dec 22, 2017",Pitch Perfect 3,45000000,104897530,185736412,290633942,245633942,545.8532044444445,"Comedy,Music",5.8,93.0
63,"Jul 20, 1994",The Client,45000000,92115211,117615211,209730422,164730422,366.06760444444444,"Drama,Thriller",6.9,123.0
64,"Nov 23, 2011",The Muppets,45000000,88625922,160971922,249597844,204597844,454.6618755555555,"Adventure,Comedy,Family",7.1,103.0
68,"Oct 7, 2016",The Girl on the Train,45000000,75395035,174278214,249673249,204673249,454.8294422222222,Thriller,4.4,80.0
68,"Oct 7, 2016",The Girl on the Train,45000000,75395035,174278214,249673249,204673249,454.8294422222222,"Crime,Drama,Mystery",6.5,112.0
73,"Mar 19, 2010",The Bounty Hunter,45000000,67061228,135808837,202870065,157870065,350.8223666666667,"Action,Comedy,Romance",5.6,110.0
79,"Aug 9, 1996",Jack,45000000,58617334,58617334,117234668,72234668,160.52148444444444,Drama,7.3,103.0
79,"Aug 9, 1996",Jack,45000000,58617334,58617334,117234668,72234668,160.52148444444444,"Crime,Drama",5.9,97.0
81,"Dec 9, 2016",Office Christmas Party,45000000,54767494,91323299,146090793,101090793,224.64620666666667,Comedy,5.8,105.0
88,"Jul 6, 2012",Savages,45000000,47323100,82513490,129836590,84836590,188.52575555555555,"Crime,Drama,Thriller",6.5,131.0
90,"May 23, 2014",Blended,45000000,46290741,127990741,174281482,129281482,287.2921822222222,"Comedy,Romance",6.5,117.0
91,"Jun 16, 2017",All Eyez on Me,45000000,44922302,54876855,99799157,54799157,121.77590444444444,"Biography,Drama,Music",5.8,139.0
3,"Nov 4, 1994",Frankenstein,45000000,22006296,112006296,134012592,89012592,197.80576000000002,Drama,9.0,130.0
3,"Nov 4, 1994",Frankenstein,45000000,22006296,112006296,134012592,89012592,197.80576000000002,"Drama,Horror",1.9,82.0
3,"Nov 4, 1994",Frankenstein,45000000,22006296,112006296,134012592,89012592,197.80576000000002,"Horror,Sci-Fi,Thriller",5.1,89.0
6,"May 3, 2019",UglyDolls,45000000,19894664,24644664,44539328,-460672,-1.0237155555555555,"Adventure,Animation,Comedy",4.5,87.0
7,"Jan 19, 2001",The Pledge,45000000,19719930,29406132,49126062,4126062,9.169026666666667,"Drama,Family",6.3,118.0
10,"Jul 1, 2005",Rebound,45000000,16809014,17492014,34301028,-10698972,-23.775493333333333,"Horror,Mystery,Thriller",4.2,84.0
11,"Feb 19, 2010",The Ghost Writer,45000000,15541549,65532491,81074040,36074040,80.16453333333334,"Drama,Mystery,Thriller",7.2,128.0
15,"Sep 21, 2012",Dredd,45000000,13414714,41467606,54882320,9882320,21.960711111111113,"Action,Crime,Sci-Fi",7.1,95.0
16,"Oct 28, 2011",The Rum Diary,45000000,13109815,21544732,34654547,-10345453,-22.989895555555556,"Comedy,Drama",6.2,119.0
18,"Dec 21, 2018",Welcome to Marwen,45000000,10763520,12874922,23638442,-21361558,-47.470128888888894,"Biography,Comedy,Drama",6.1,116.0
19,"Oct 21, 2011",Johnny English Reborn,45000000,8406711,164640401,173047112,128047112,284.5491377777778,"Action,Adventure,Comedy",6.3,101.0
24,"Dec 25, 2002",Pinocchio,45000000,3681811,31681811,35363622,-9636378,-21.414173333333334,"Animation,Family,Fantasy",6.3,75.0
24,"Dec 25, 2002",Pinocchio,45000000,3681811,31681811,35363622,-9636378,-21.414173333333334,Documentary,6.8,75.0
26,"Dec 31, 2012",Foodfight!,45000000,0,73706,73706,-44926294,-99.83620888888889,"Action,Animation,Comedy",1.9,91.0
27,"Oct 12, 2012",Argo,44500000,136025503,227140757,363166260,318666260,716.1039550561798,"Biography,Drama,Thriller",7.7,120.0
31,"Jul 30, 2010",Charlie St. Cloud,44000000,31206263,48478084,79684347,35684347,81.10078863636365,"Drama,Fantasy,Romance",6.5,99.0
32,"Feb 2, 1996",The Juror,44000000,22730924,22730924,45461848,1461848,3.322381818181818,Drama,6.3,114.0
33,"Feb 6, 2014",The Interview,44000000,6105175,12342632,18447807,-25552193,-58.0731659090909,Comedy,6.5,112.0
34,"Nov 19, 1980",Heaven's Gate,44000000,3484331,3484523,6968854,-37031146,-84.16169545454547,Documentary,6.8,47.0
35,"Jun 28, 2013",The Heat,43000000,159581587,229727774,389309361,346309361,805.3706069767442,"Action,Comedy,Crime",6.6,117.0
41,"Jan 6, 2017",A Monster Calls,43000000,3740823,46414530,50155353,7155353,16.64035581395349,"Animation,Drama,Fantasy",7.5,108.0
42,"Jan 28, 2011",The Mechanic,42500000,29121498,76347393,105468891,62968891,148.16209647058824,"Action,Crime,Thriller",6.6,93.0
44,"Mar 16, 2012",21 Jump Street,42000000,138447667,202812429,341260096,299260096,712.5240380952381,"Action,Comedy,Crime",7.2,109.0
48,"Jul 1, 1992",Boomerang,42000000,70052444,131052444,201104888,159104888,378.8211619047619,"Drama,Romance",6.6,101.0
48,"Jul 1, 1992",Boomerang,42000000,70052444,131052444,201104888,159104888,378.8211619047619,"Action,Thriller",5.8,120.0
48,"Jul 1, 1992",Boomerang,42000000,70052444,131052444,201104888,159104888,378.8211619047619,Comedy,6.3,90.0
51,"May 12, 2017",Snatched,42000000,45852178,57852177,103704355,61704355,146.91513095238096,Comedy,5.5,81.0
51,"May 12, 2017",Snatched,42000000,45852178,57852177,103704355,61704355,146.91513095238096,"Action,Adventure,Comedy",4.5,90.0
52,"Oct 12, 2012",Here Comes the Boom,42000000,45290318,73239258,118529576,76529576,182.2132761904762,"Action,Comedy,Sport",6.4,105.0
55,"Mar 11, 2011",Red Riding Hood,42000000,37662162,91678442,129340604,87340604,207.95381904761902,"Fantasy,Horror,Mystery",5.5,100.0
58,"Dec 25, 2018",Holmes & Watson,42000000,30568743,41926605,72495348,30495348,72.60797142857143,"Adventure,Comedy,Crime",3.8,90.0
59,"Jan 27, 2012",One for the Money,42000000,26414527,36197221,62611748,20611748,49.07559047619048,"Action,Comedy,Crime",5.3,91.0
63,"Oct 2, 1992",Hero,42000000,19487173,66787173,86274346,44274346,105.41510952380952,"Action,Drama,Thriller",3.8,163.0
63,"Oct 2, 1992",Hero,42000000,19487173,66787173,86274346,44274346,105.41510952380952,"Crime,Drama",6.3,120.0
63,"Oct 2, 1992",Hero,42000000,19487173,66787173,86274346,44274346,105.41510952380952,"Action,Drama,Romance",3.7,145.0
64,"Jan 27, 2012",Man on a Ledge,42000000,18620000,49621440,68241440,26241440,62.47961904761905,"Action,Adventure,Crime",6.6,102.0
65,"Dec 3, 2010",The Warrior's Way,42000000,5666340,8514325,14180665,-27819335,-66.23651190476191,"Action,Fantasy,Western",6.3,100.0
71,"May 31, 2019",Rocketman,41000000,57342725,108642725,165985450,124985450,304.84256097560973,"Biography,Drama,Music",7.7,121.0
74,"Oct 14, 2011",The Big Year,41000000,7204138,7684524,14888662,-26111338,-63.68619024390244,Comedy,6.2,100.0
77,"Jun 11, 2010",The Karate Kid,40000000,176591618,351774938,528366556,488366556,1220.91639,"Action,Drama,Family",6.2,140.0
78,"Feb 13, 2015",Fifty Shades of Grey,40000000,166167230,570998101,737165331,697165331,1742.9133275000002,"Drama,Romance,Thriller",4.1,125.0
79,"Jun 19, 2009",The Proposal,40000000,163958031,314709717,478667748,438667748,1096.66937,Documentary,5.6,86.0
80,"Dec 13, 2013",American Hustle,40000000,150117807,257878294,407996101,367996101,919.9902525000001,"Crime,Drama",7.2,138.0
83,"Jul 25, 2014",Lucy,40000000,126573960,457507776,584081736,544081736,1360.20434,"Action,Sci-Fi,Thriller",6.4,89.0
83,"Jul 25, 2014",Lucy,40000000,126573960,457507776,584081736,544081736,1360.20434,Documentary,7.0,40.0
84,"Dec 25, 2013",Lone Survivor,40000000,125095601,149804632,274900233,234900233,587.2505825000001,"Action,Biography,Drama",7.5,121.0
91,"Oct 1, 2010",The Social Network,40000000,96962694,224922135,321884829,281884829,704.7120725,"Biography,Drama",7.7,120.0
95,"Jan 15, 2016",Ride Along 2,40000000,90862685,124827316,215690001,175690001,439.2250025,"Action,Comedy,Crime",5.9,102.0
97,"Mar 27, 2015",Get Hard,40000000,90411453,106511453,196922906,156922906,392.307265,"Comedy,Crime",6.0,100.0
100,"Oct 14, 2016",The Accountant,40000000,86260045,152962083,239222128,199222128,498.05532,"Action,Crime,Drama",7.3,128.0
1,"Nov 14, 2014",Dumb and Dumber To,40000000,86208010,156553592,242761602,202761602,506.904005,"Adventure,Comedy",5.6,109.0
2,"Apr 25, 2014",The Other Woman,40000000,83911193,195111193,279022386,239022386,597.555965,"Comedy,Romance",6.0,109.0
6,"Sep 25, 2015",The Intern,40000000,75764672,197115710,272880382,232880382,582.200955,"Comedy,Drama",7.1,121.0
10,"Oct 16, 2015",Bridge of Spies,40000000,72313754,162498338,234812092,194812092,487.03022999999996,"Drama,History,Thriller",7.6,142.0
17,"Nov 4, 2016",Hacksaw Ridge,40000000,67209615,168904682,236114297,196114297,490.28574249999997,"Biography,Drama,History",8.1,139.0
21,"Feb 18, 2011",Unknown,40000000,63686397,136123083,199809480,159809480,399.5237,"Action,Mystery,Thriller",6.9,113.0
21,"Feb 18, 2011",Unknown,40000000,63686397,136123083,199809480,159809480,399.5237,Drama,6.9,96.0
22,"Jun 4, 2010",Get Him to the Greek,40000000,61153526,91455875,152609401,112609401,281.52350249999995,"Adventure,Comedy,Music",6.4,109.0
25,"Mar 18, 2011",The Lincoln Lawyer,40000000,58009200,87145086,145154286,105154286,262.885715,"Crime,Drama,Thriller",7.3,118.0
31,"Nov 26, 2014",Horrible Bosses 2,40000000,54445357,105945357,160390714,120390714,300.976785,"Comedy,Crime",6.3,108.0
35,"Jul 9, 2010",Predators,40000000,52000688,127234389,179235077,139235077,348.0876925,"Action,Adventure,Sci-Fi",6.4,107.0
36,"Aug 15, 2012",The Odd Life of Timothy Green,40000000,51853450,55249159,107102609,67102609,167.7565225,"Comedy,Drama,Family",6.6,105.0
43,"Jun 20, 2014",Jersey Boys,40000000,47047013,65282732,112329745,72329745,180.8243625,"Biography,Drama,Music",6.8,134.0
49,"Aug 12, 2011",Final Destination 5,40000000,42587643,155011165,197598808,157598808,393.99701999999996,Horror,5.9,92.0
50,"Nov 16, 2018",Widows,40000000,42402632,73866088,116268720,76268720,190.6718,"Comedy,Drama",6.3,100.0
50,"Nov 16, 2018",Widows,40000000,42402632,73866088,116268720,76268720,190.6718,"Crime,Drama,Thriller",7.0,129.0
54,"Jul 18, 2014",Sex Tape,40000000,38543473,126069509,164612982,124612982,311.53245499999997,"Comedy,Romance",5.1,94.0
55,"Apr 15, 2011",Scream 4,40000000,38180928,95989590,134170518,94170518,235.42629499999998,"Horror,Mystery",6.2,111.0
58,"Mar 18, 2011",Paul,40000000,37412945,101162106,138575051,98575051,246.4376275,"Adventure,Comedy,Sci-Fi",7.0,104.0
58,"Mar 18, 2011",Paul,40000000,37412945,101162106,138575051,98575051,246.4376275,Drama,4.8,71.0
59,"Dec 19, 2012",The Guilt Trip,40000000,37134215,41294674,78428889,38428889,96.07222250000001,"Comedy,Drama",5.8,95.0
60,"Aug 26, 2011",Colombiana,40000000,36665854,72295262,108961116,68961116,172.40279,"Action,Drama,Thriller",6.4,108.0
62,"Jan 12, 2018",The Commuter,40000000,36343858,101985431,138329289,98329289,245.8232225,"Action,Mystery,Thriller",6.3,105.0
67,"Apr 8, 2011",Arthur,40000000,33035397,47787943,80823340,40823340,102.05835,"Comedy,Romance",5.7,110.0
69,"Dec 21, 2016",Patriots Day,40000000,31886361,52837989,84724350,44724350,111.810875,"Action,Crime,Drama",7.4,133.0
73,"Nov 10, 2010",Morning Glory,40000000,31011732,59795070,90806802,50806802,127.017005,"Comedy,Drama,Romance",6.5,107.0
75,"May 3, 2019",Long Shot,40000000,30202860,43711031,73913891,33913891,84.7847275,"Comedy,Romance",7.2,125.0
76,"Aug 25, 2000",The Art of War,40000000,30199105,30199105,60398210,20398210,50.995525,War,2.8,96.0
77,"Dec 25, 2013",Grudge Match,40000000,29807260,69807260,99614520,59614520,149.0363,"Comedy,Drama,Sport",6.4,113.0
81,"Aug 11, 2017",The Nut Job 2: Nutty by Nature,40000000,28370522,57438389,85808911,45808911,114.52227749999999,"Adventure,Animation,Comedy",5.5,91.0
84,"Jan 27, 2017",Resident Evil: The Final Chapter,40000000,26844692,314101190,340945882,300945882,752.364705,"Action,Horror,Sci-Fi",5.6,107.0
86,"Jun 30, 2017",The House,40000000,25584504,31192425,56776929,16776929,41.9423225,"Drama,Mystery,Thriller",4.6,109.0
86,"Jun 30, 2017",The House,40000000,25584504,31192425,56776929,16776929,41.9423225,Animation,7.3,72.0
86,"Jun 30, 2017",The House,40000000,25584504,31192425,56776929,16776929,41.9423225,Thriller,4.5,90.0
86,"Jun 30, 2017",The House,40000000,25584504,31192425,56776929,16776929,41.9423225,"Comedy,Crime",5.6,88.0
88,"Apr 5, 2007",The Reaping,40000000,25126214,62226214,87352428,47352428,118.38107,"Comedy,Horror,Thriller",4.9,84.0
89,"Jan 7, 2011",Season of the Witch,40000000,24827228,91126600,115953828,75953828,189.88457,"Action,Adventure,Fantasy",5.4,95.0
90,"Jun 3, 1994",Renaissance Man,40000000,24172899,24172899,48345798,8345798,20.864494999999998,Documentary,4.7,90.0
94,"Aug 26, 2016",Mechanic: Resurrection,40000000,21218403,109738840,130957243,90957243,227.3931075,"Action,Adventure,Thriller",5.7,98.0
99,"Feb 3, 2012",Big Miracle,40000000,20157300,25268680,45425980,5425980,13.564950000000001,"Biography,Drama,Family",6.5,107.0
100,"Dec 21, 2012",The Impossible,40000000,19019882,169590606,188610488,148610488,371.52622,"Drama,History,Thriller",7.6,114.0
1,"Mar 9, 2012",A Thousand Words,40000000,18450127,20790486,39240613,-759387,-1.8984675,"Comedy,Drama",5.9,91.0
15,"Mar 20, 2015",The Gunman,40000000,10664749,18594227,29258976,-10741024,-26.852559999999997,"Action,Crime,Drama",5.8,115.0
19,"Aug 16, 2013",Paranoia,40000000,7388654,16340767,23729421,-16270579,-40.6764475,"Drama,Thriller",5.7,106.0
19,"Aug 16, 2013",Paranoia,40000000,7388654,16340767,23729421,-16270579,-40.6764475,Thriller,5.3,87.0
21,"Jul 10, 2015",Baahubali: The Beginning,40000000,6738000,26736665,33474665,-6525335,-16.3133375,"Action,Drama",8.1,159.0
22,"Mar 9, 2018",The Hurricane Heist,40000000,6115824,30963684,37079508,-2920492,-7.30123,"Action,Adventure,Crime",5.1,103.0
24,"Nov 25, 2015",Victor Frankenstein,40000000,5775076,31124367,36899443,-3100557,-7.7513925,"Drama,Horror,Sci-Fi",6.0,110.0
27,"Jun 27, 2014",Snowpiercer,40000000,4563029,88069880,92632909,52632909,131.58227250000002,"Action,Drama,Sci-Fi",7.1,126.0
31,"Jul 1, 1986",Pirates,40000000,1641825,6341825,7983650,-32016350,-80.040875,"Action,Adventure,Comedy",6.6,130.0
36,"Sep 24, 2004",The Last Shot,40000000,463730,463730,927460,-39072540,-97.68135,Action,8.0,47.0
37,"Mar 16, 2007",Nomad,40000000,79123,79123,158246,-39841754,-99.604385,Drama,3.1,83.0
40,"Nov 11, 2016",USS Indianapolis: Men of Courage,40000000,0,1663785,1663785,-38336215,-95.8405375,"Action,Drama,History",5.2,128.0
48,"Oct 5, 2012",Frankenweenie,39000000,35287788,81150788,116438576,77438576,198.56045128205128,"Animation,Comedy,Family",7.0,87.0
50,"Sep 30, 2005",Serenity,39000000,25514517,40319440,65833957,26833957,68.80501794871795,"Drama,Mystery,Sci-Fi",5.3,106.0
59,"Jun 2, 2017",Captain Underpants: The First Epic Movie,38000000,73921000,126577874,200498874,162498874,427.6286157894737,"Action,Animation,Comedy",6.2,89.0
60,"Apr 17, 2015",Paul Blart: Mall Cop 2,38000000,71091594,107650646,178742240,140742240,370.37431578947366,"Action,Comedy,Crime",4.4,94.0
62,"Dec 23, 2016",Why Him?,38000000,60323786,117425156,177748942,139748942,367.7603736842105,Comedy,6.2,111.0
63,"Apr 22, 2011",Water for Elephants,38000000,58709717,116809717,175519434,137519434,361.89324736842104,"Drama,Romance",6.9,120.0
64,"Oct 8, 2010",Life as We Know It,38000000,53374681,105887837,159262518,121262518,319.11188947368424,"Comedy,Drama,Romance",6.6,114.0
66,"Sep 6, 2013",Riddick,38000000,42025135,94763758,136788893,98788893,259.9707710526316,"Action,Adventure,Sci-Fi",6.4,119.0
69,"Jan 22, 2016",The 5th Wave,38000000,34912982,111336398,146249380,108249380,284.8667894736842,"Action,Adventure,Drama",5.2,112.0
70,"Feb 6, 2009",Push,38000000,31811527,49678401,81489928,43489928,114.44717894736843,Documentary,7.3,92.0
71,"Sep 20, 2013",Rush,38000000,26947624,98230839,125178463,87178463,229.41700789473686,"Action,Biography,Drama",8.1,123.0
71,"Sep 20, 2013",Rush,38000000,26947624,98230839,125178463,87178463,229.41700789473686,"Comedy,Romance",7.9,87.0
71,"Sep 20, 2013",Rush,38000000,26947624,98230839,125178463,87178463,229.41700789473686,"Crime,Thriller",3.8,110.0
75,"Oct 20, 2017",Only the Brave,38000000,18340051,24555177,42895228,4895228,12.882178947368422,"Action,Biography,Drama",7.7,134.0
77,"Oct 14, 2011",The Thing,38000000,16999934,27573078,44573012,6573012,17.2974,"Horror,Mystery,Sci-Fi",6.2,103.0
82,"Sep 21, 2018",The Sisters Brothers,38000000,3143056,13143056,16286112,-21713888,-57.141810526315794,"Adventure,Comedy,Crime",7.0,122.0
85,"Jan 11, 2019",The Upside,37500000,108235497,119024536,227260033,189760033,506.02675466666665,"Comedy,Drama",6.7,126.0
86,"May 18, 2012",What to Expect When You're Expecting,37500000,41152203,88473016,129625219,92125219,245.66725066666666,"Comedy,Drama,Romance",5.7,110.0
87,"Sep 14, 2012",The Master,37500000,16247159,50647416,66894575,29394575,78.38553333333334,Drama,7.1,138.0
87,"Sep 14, 2012",The Master,37500000,16247159,50647416,66894575,29394575,78.38553333333334,"Action,History",4.8,86.0
90,"Aug 7, 2013",We're the Millers,37000000,150394119,267816276,418210395,381210395,1030.2983648648649,"Comedy,Crime",7.0,110.0
91,"Nov 25, 2015",Creed,37000000,109767581,173567581,283335162,246335162,665.7707081081081,Horror,6.6,77.0
91,"Nov 25, 2015",Creed,37000000,109767581,173567581,283335162,246335162,665.7707081081081,"Drama,Sport",7.6,133.0
91,"Nov 25, 2015",Creed,37000000,109767581,173567581,283335162,246335162,665.7707081081081,"Crime,Drama",5.8,80.0
92,"Sep 17, 2010",The Town,37000000,92186262,152566881,244753143,207753143,561.494981081081,"Crime,Drama,Thriller",7.6,125.0
93,"Sep 23, 2011",Dolphin Tale,37000000,72286779,96068724,168355503,131355503,355.01487297297297,"Drama,Family",6.9,113.0
94,"Feb 23, 2018",Game Night,37000000,69179066,117378084,186557150,149557150,404.20851351351354,"Action,Comedy,Crime",7.0,100.0
99,"Feb 26, 2010",Cop Out,37000000,44875481,55909910,100785391,63785391,172.39294864864866,"Action,Comedy,Crime",5.6,107.0
100,"Jan 28, 2011",The Rite,37000000,33047633,97143987,130191620,93191620,251.86924324324323,"Drama,Horror,Mystery",6.0,114.0
3,"May 29, 2015",Aloha,37000000,21052030,25387091,46439121,9439121,25.51113783783784,"Comedy,Drama,Romance",5.4,105.0
5,"Oct 5, 2018",A Star is Born,36000000,215288866,433449571,648738437,612738437,1702.051213888889,"Documentary,Music",5.1,75.0
10,"Mar 26, 2010",Hot Tub Time Machine,36000000,50269859,65967750,116237609,80237609,222.88224722222222,"Comedy,Sci-Fi",6.4,101.0
11,"May 2, 1997",Breakdown,36000000,50159144,50159144,100318288,64318288,178.66191111111112,"Drama,Thriller",5.3,110.0
12,"Sep 12, 2014",Dolphin Tale 2,36000000,42024533,57824533,99849066,63849066,177.35851666666667,"Drama,Family",6.4,107.0
13,"Dec 16, 2016",Collateral Beauty,36000000,31016021,85309093,116325114,80325114,223.1253166666667,"Drama,Romance",6.8,97.0
21,"May 6, 2011",There Be Dragons,36000000,1069334,4020990,5090324,-30909676,-85.86021111111111,"Biography,Drama,War",5.8,122.0
22,"Apr 14, 2017",Queen of the Desert,36000000,0,1578543,1578543,-34421457,-95.61515833333334,"Adventure,Biography,Drama",5.7,128.0
24,"Sep 8, 2017",It,35000000,327481748,697457969,1024939717,989939717,2828.3991914285716,"Horror,Thriller",7.4,135.0
29,"Dec 22, 2010",True Grit,35000000,171243005,252276928,423519933,388519933,1110.0569514285714,"Adventure,Drama,Western",7.6,110.0
31,"Sep 18, 1998",Rush Hour,35000000,141186864,245300000,386486864,351486864,1004.2481828571429,Documentary,6.6,80.0
32,"Feb 8, 2013",Identity Thief,35000000,134506920,175361578,309868498,274868498,785.3385657142857,"Adventure,Comedy,Crime",5.7,111.0
34,"Jul 8, 2011",Horrible Bosses,35000000,117538559,212417601,329956160,294956160,842.7318857142858,"Comedy,Crime",6.9,98.0
36,"Jul 17, 2015",Trainwreck,35000000,110212700,141123897,251336597,216336597,618.1045628571429,"Comedy,Drama,Romance",6.2,125.0
37,"Dec 13, 2013",Saving Mr. Banks,35000000,83299761,114962525,198262286,163262286,466.46367428571426,"Biography,Comedy,Drama",7.5,125.0
39,"Mar 28, 2008",21,35000000,81159365,159846429,241005794,206005794,588.5879828571428,Horror,7.2,98.0
47,"Jul 29, 2005",Sky High,35000000,63939454,83109359,147048813,112048813,320.13946571428573,"Adventure,Documentary,Drama",7.4,70.0
49,"Apr 30, 2010",A Nightmare on Elm Street,35000000,63075011,117729621,180804632,145804632,416.58466285714286,"Crime,Drama,Horror",5.2,95.0
53,"Oct 8, 2010",Secretariat,35000000,59699513,60376247,120075760,85075760,243.0736,"Biography,Drama,Family",7.2,123.0
55,"Jul 22, 2011",Friends with Benefits,35000000,55802754,146595891,202398645,167398645,478.28184285714286,"Comedy,Romance",6.6,109.0
56,"May 20, 2016",Neighbors 2: Sorority Rising,35000000,55340730,108757621,164098351,129098351,368.85243142857144,Comedy,5.7,92.0
59,"Jun 29, 2018",Sicario: Day of the Soldado,35000000,50065850,75885196,125951046,90951046,259.86013142857144,"Action,Crime,Drama",7.1,122.0
62,"May 22, 2015",Poltergeist,35000000,47425125,95713069,143138194,108138194,308.9662685714286,"Horror,Thriller",4.9,93.0
63,"Oct 12, 2018",Goosebumps 2: Haunted Halloween,35000000,46697321,93291478,139988799,104988799,299.96799714285714,"Adventure,Comedy,Family",5.6,90.0
64,"Jan 19, 2018",12 Strong,35000000,45819713,71118378,116938091,81938091,234.10883142857145,"Action,Drama,History",6.6,130.0
72,"May 6, 2011",Something Borrowed,35000000,39046489,65084116,104130605,69130605,197.51601428571428,"Comedy,Drama,Romance",5.9,112.0
74,"Oct 28, 2011",In Time,35000000,37553932,165103952,202657884,167657884,479.0225257142857,"Action,Crime,Drama",6.7,109.0
75,"Apr 23, 2010",The Back-up Plan,35000000,37490007,75281179,112771186,77771186,222.20338857142855,"Comedy,Romance",5.4,104.0
76,"Nov 9, 2011",J. Edgar,35000000,37306030,84606030,121912060,86912060,248.32017142857143,"Biography,Crime,Drama",6.6,137.0
78,"Aug 17, 2018",Mile 22,35000000,36108758,66295121,102403879,67403879,192.58251142857142,"Action,Adventure,Thriller",6.1,94.0
79,"May 8, 2015",Hot Pursuit,35000000,34580201,45671512,80251713,45251713,129.29060857142858,"Action,Comedy,Crime",5.1,87.0
80,"Dec 25, 2015",Concussion,35000000,34531832,50363790,84895622,49895622,142.55892,Drama,5.7,96.0
80,"Dec 25, 2015",Concussion,35000000,34531832,50363790,84895622,49895622,142.55892,"Biography,Drama,Sport",7.1,123.0
81,"Oct 13, 2017",The Foreigner,35000000,34393507,140783360,175176867,140176867,400.5053342857143,"Action,Thriller",7.0,113.0
81,"Oct 13, 2017",The Foreigner,35000000,34393507,140783360,175176867,140176867,400.5053342857143,"Comedy,Romance",6.8,100.0
82,"Dec 3, 2004",Closer,35000000,33987757,116177695,150165452,115165452,329.04414857142854,Drama,5.7,87.0
89,"Jun 1, 2018",Adrift,35000000,31445011,57897191,89342202,54342202,155.26343428571428,Drama,6.0,65.0
89,"Jun 1, 2018",Adrift,35000000,31445011,57897191,89342202,54342202,155.26343428571428,"Action,Adventure,Biography",6.6,96.0
91,"Jan 6, 2017",Underworld: Blood Wars,35000000,30353973,81209222,111563195,76563195,218.75198571428572,"Action,Adventure,Fantasy",5.8,91.0
96,"Sep 23, 2011",Abduction,35000000,28087155,86648359,114735514,79735514,227.8157542857143,"Action,Mystery,Thriller",5.1,106.0
96,"Sep 23, 2011",Abduction,35000000,28087155,86648359,114735514,79735514,227.8157542857143,"Horror,Thriller",5.2,84.0
96,"Sep 23, 2011",Abduction,35000000,28087155,86648359,114735514,79735514,227.8157542857143,"Action,Comedy,Drama",3.0,90.0
96,"Sep 23, 2011",Abduction,35000000,28087155,86648359,114735514,79735514,227.8157542857143,"Action,Sci-Fi",6.1,106.0
100,"Oct 19, 2012",Alex Cross,35000000,25888412,35426759,61315171,26315171,75.18620285714286,"Action,Crime,Mystery",5.1,101.0
4,"Nov 9, 2001",Heist,35000000,23483357,28906817,52390174,17390174,49.68621142857143,"Action,Crime,Thriller",6.1,93.0
4,"Nov 9, 2001",Heist,35000000,23483357,28906817,52390174,17390174,49.68621142857143,Action,6.4,47.0
6,"Mar 4, 2016",Whiskey Tango Foxtrot,35000000,23083334,25350747,48434081,13434081,38.38308857142857,"Biography,Comedy,Drama",6.6,112.0
8,"Aug 21, 2015",Hitman: Agent 47,35000000,22467450,82182803,104650253,69650253,199.00072285714285,"Action,Adventure,Crime",5.7,96.0
10,"Aug 24, 2012",Premium Rush,35000000,20275446,31393201,51668647,16668647,47.62470571428572,"Action,Crime,Thriller",6.5,91.0
11,"Jan 18, 2013",Broken City,35000000,19701164,34480045,54181209,19181209,54.80345428571428,"Crime,Drama,Thriller",6.2,109.0
14,"Feb 25, 2005",Cursed,35000000,19294901,25114901,44409802,9409802,26.88514857142857,"Drama,War",6.2,112.0
14,"Feb 25, 2005",Cursed,35000000,19294901,25114901,44409802,9409802,26.88514857142857,Comedy,8.3,81.0
17,"Apr 30, 2010",Furry Vengeance,35000000,17630465,39340177,56970642,21970642,62.77326285714285,"Comedy,Family",3.8,92.0
18,"Jan 25, 2013",Parker,35000000,17616641,48543388,66160029,31160029,89.02865428571428,"Action,Crime,Thriller",6.2,118.0
20,"Sep 15, 2000",Bait,35000000,15325127,15471969,30797096,-4202904,-12.008297142857142,"Action,Adventure,Drama",5.2,93.0
20,"Sep 15, 2000",Bait,35000000,15325127,15471969,30797096,-4202904,-12.008297142857142,"Drama,Thriller",5.5,82.0
20,"Sep 15, 2000",Bait,35000000,15325127,15471969,30797096,-4202904,-12.008297142857142,Drama,7.0,89.0
24,"May 27, 2011",The Tree of Life,35000000,13305665,61721826,75027491,40027491,114.36426,"Drama,Fantasy",6.8,139.0
26,"Aug 11, 2006",Zoom,35000000,11989328,12506188,24495516,-10504484,-30.01281142857143,"Animation,Comedy,Drama",6.1,96.0
26,"Aug 11, 2006",Zoom,35000000,11989328,12506188,24495516,-10504484,-30.01281142857143,"Comedy,Drama,Romance",7.2,158.0
29,"Mar 28, 2014",Sabotage,35000000,10508518,18376443,28884961,-6115039,-17.47154,"Action,Crime,Drama",5.7,109.0
32,"Mar 6, 2015",Unfinished Business,35000000,10219501,13214051,23433552,-11566448,-33.046994285714284,"Comedy,Drama",5.4,91.0
33,"Sep 30, 2015",The Walk,35000000,10161183,61492104,71653287,36653287,104.72367714285716,"Crime,Thriller",6.8,89.0
33,"Sep 30, 2015",The Walk,35000000,10161183,61492104,71653287,36653287,104.72367714285716,"Adventure,Biography,Drama",7.3,123.0
35,"Nov 29, 2013",Mandela: Long Walk to Freedom,35000000,8323085,29890402,38213487,3213487,9.181391428571429,"Biography,Drama,History",7.1,141.0
39,"Mar 11, 2016",The Brothers Grimsby,35000000,6864016,28720470,35584486,584486,1.6699599999999999,"Action,Adventure,Comedy",6.2,83.0
40,"Oct 20, 2017",The Snowman,35000000,6670765,43226146,49896911,14896911,42.562602857142856,"Crime,Drama,Mystery",5.1,119.0
44,"Jan 28, 2011",Biutiful,35000000,5101237,24687524,29788761,-5211239,-14.889254285714285,"Drama,Romance",7.5,148.0
47,"Apr 22, 2016",A Hologram for the King,35000000,4212494,11846010,16058504,-18941496,-54.11856,"Comedy,Drama,Romance",6.1,98.0
49,"Oct 3, 1986",Playing for Keeps,35000000,2000000,2000000,4000000,-31000000,-88.57142857142857,"Comedy,Romance,Sport",5.7,105.0
53,"Sep 14, 2012",Stolen,35000000,289773,17967746,18257519,-16742481,-47.835660000000004,"Action,Crime,Thriller",5.5,96.0
53,"Sep 14, 2012",Stolen,35000000,289773,17967746,18257519,-16742481,-47.835660000000004,"Crime,Drama",4.5,86.0
54,"Oct 14, 2011",Trespass,35000000,16816,786532,803348,-34196652,-97.70472,"Crime,Drama,Thriller",5.3,91.0
56,"Mar 13, 2015",The Lovers,35000000,0,53899,53899,-34946101,-99.84600285714286,"Action,Adventure,Romance",4.6,109.0
56,"Mar 13, 2015",The Lovers,35000000,0,53899,53899,-34946101,-99.84600285714286,"Comedy,Drama,Romance",6.1,97.0
58,"Dec 25, 2011",The Darkest Hour,34800000,21443494,62831715,84275209,49475209,142.1701408045977,"Action,Adventure,Horror",4.9,89.0
58,"Dec 25, 2011",The Darkest Hour,34800000,21443494,62831715,84275209,49475209,142.1701408045977,"Documentary,News",6.4,52.0
59,"Jun 28, 2017",Baby Driver,34000000,107825862,228104185,335930047,301930047,888.0295500000001,"Action,Crime,Drama",7.6,113.0
60,"Sep 19, 2014",The Maze Runner,34000000,102427862,348319861,450747723,416747723,1225.7285970588234,"Action,Mystery,Sci-Fi",6.8,113.0
61,"Apr 10, 2015",The Longest Ride,34000000,37446117,63802928,101249045,67249045,197.79130882352942,"Drama,Romance",7.1,123.0
64,"Aug 3, 2018",The Darkest Minds,34000000,12695691,38361428,51057119,17057119,50.16799705882353,"Action,Adventure,Drama",5.7,104.0
68,"Sep 5, 2014",Thunder and the House of Magic,34000000,4091,62582520,62586611,28586611,84.07826764705882,"Adventure,Animation,Comedy",6.3,85.0
73,"Jul 8, 2016",Mike and Dave Need Wedding Dates,33000000,46009673,75898100,121907773,88907773,269.4174939393939,"Adventure,Comedy,Romance",6.0,98.0
74,"Jul 27, 2012",Step Up Revolution,33000000,35074677,165552290,200626967,167626967,507.96050606060606,"Drama,Music,Romance",6.5,99.0
77,"Sep 8, 2000",The Watcher,33000000,28946615,47267829,76214444,43214444,130.95286060606063,Drama,7.8,45.0
77,"Sep 8, 2000",The Watcher,33000000,28946615,47267829,76214444,43214444,130.95286060606063,"Horror,Thriller",5.4,89.0
77,"Sep 8, 2000",The Watcher,33000000,28946615,47267829,76214444,43214444,130.95286060606063,"Horror,Mystery,Thriller",4.4,97.0
78,"Apr 27, 2012",Safe,33000000,17142080,41495213,58637293,25637293,77.68876666666667,"Action,Crime,Thriller",6.5,94.0
78,"Apr 27, 2012",Safe,33000000,17142080,41495213,58637293,25637293,77.68876666666667,Thriller,3.8,75.0
79,"Mar 14, 2008",Doomsday,33000000,11008770,21621188,32629958,-370042,-1.1213393939393939,"Action,Sci-Fi",3.8,95.0
82,"Jul 31, 2015",The Young and Prodigious T.S. Spivet,33000000,176847,357687,534534,-32465466,-98.3802,"Action,Adventure,Comedy",7.1,105.0
83,"Oct 30, 2015",Freaks of Nature,33000000,70958,70958,141916,-32858084,-99.56995151515152,"Comedy,Horror,Sci-Fi",5.9,92.0
85,"May 13, 2011",Bridesmaids,32500000,169211718,289632023,458843741,426343741,1311.8268953846155,"Comedy,Romance",6.8,125.0
87,"Apr 26, 2013",The Big Wedding,32500000,21819348,48425971,70245319,37745319,116.13944307692307,"Comedy,Drama,Romance",5.6,89.0
88,"Feb 24, 2012",Wanderlust,32500000,17288155,24159934,41448089,8948089,27.532581538461535,"Comedy,Romance",5.6,98.0
95,"Aug 27, 2010",Takers,32000000,57744720,70587268,128331988,96331988,301.0374625,"Action,Crime,Thriller",6.2,107.0
96,"Apr 1, 2011",Source Code,32000000,54712227,140428499,195140726,163140726,509.81476875,"Action,Drama,Sci-Fi",7.5,93.0
99,"Apr 20, 2018",I Feel Pretty,32000000,48795601,91553797,140349398,108349398,338.59186875,"Comedy,Romance",5.4,110.0
1,"Feb 18, 2011","Big Mommas: Like Father, Like Son",32000000,37915414,82332450,120247864,88247864,275.774575,"Action,Comedy,Crime",4.4,107.0
2,"Jan 15, 1993",Alive,32000000,36299670,36299670,72599340,40599340,126.87293749999999,Drama,6.8,179.0
2,"Jan 15, 1993",Alive,32000000,36299670,36299670,72599340,40599340,126.87293749999999,"Horror,Thriller",6.8,91.0
2,"Jan 15, 1993",Alive,32000000,36299670,36299670,72599340,40599340,126.87293749999999,"Adventure,Biography,Drama",7.1,95.0
7,"Mar 15, 2013",The Incredible Burt Wonderstone,32000000,22537881,27392609,49930490,17930490,56.03278125,"Adventure,Comedy,Fantasy",5.9,100.0
10,"Oct 12, 2018",Bad Times at the El Royale,32000000,17839115,29204379,47043494,15043494,47.01091875,"Crime,Drama,Mystery",7.1,141.0
11,"Sep 3, 2010",Going the Distance,32000000,17804299,43603990,61408289,29408289,91.900903125,"Comedy,Romance",6.3,102.0
13,"Mar 19, 2010",Repo Men,32000000,13942007,18195238,32137245,137245,0.428890625,"Action,Crime,Sci-Fi",6.3,111.0
21,"Apr 15, 2016",Criminal,31500000,14708696,38771262,53479958,21979958,69.77764444444445,"Action,Crime,Drama",6.3,113.0
22,"Apr 12, 2013",42,31000000,95020213,97470701,192490914,161490914,520.9384322580645,"Biography,Drama,Sport",7.5,128.0
23,"Nov 2, 2012",Flight,31000000,93772375,160558438,254330813,223330813,720.4219774193549,"Drama,Thriller",7.3,138.0
27,"Mar 7, 2014",The Grand Budapest Hotel,31000000,59076019,163981261,223057280,192057280,619.5396129032258,"Adventure,Comedy,Crime",8.1,99.0
28,"Jul 29, 2015",Vacation,31000000,58884188,102306500,161190688,130190688,419.9699612903226,"Adventure,Comedy",6.1,99.0
31,"Apr 28, 2000",Frequency,31000000,44983704,68079671,113063375,82063375,264.720564516129,"Sci-Fi,Thriller",5.9,60.0
33,"Jan 22, 2010",Extraordinary Measures,31000000,12482741,15826984,28309725,-2690275,-8.678306451612903,Drama,6.5,106.0
34,"Aug 25, 2017",Birth of the Dragon,31000000,6901965,7220490,14122455,-16877545,-54.443693548387095,"Action,Biography,Drama",5.4,95.0
36,"Jun 8, 1984",Ghostbusters,30000000,242212467,295212467,537424934,507424934,1691.4164466666666,"Action,Comedy,Fantasy",5.2,116.0
38,"Aug 15, 2018",Crazy Rich Asians,30000000,174532921,238099711,412632632,382632632,1275.4421066666669,"Comedy,Romance",7.0,120.0
40,"Jun 25, 1999",Big Daddy,30000000,163479795,228641283,392121078,362121078,1207.07026,Drama,6.6,138.0
42,"Feb 10, 2012",The Vow,30000000,125014030,197618160,322632190,292632190,975.4406333333334,"Drama,Romance",6.8,104.0
43,"Jun 10, 1994",Speed,30000000,121248145,283200000,404448145,374448145,1248.1604833333333,Drama,5.9,108.0
45,"Aug 16, 2013",Lee Daniels' The Butler,30000000,116632095,177025498,293657593,263657593,878.8586433333334,"Biography,Drama",7.2,132.0
57,"Dec 18, 2015",Sisters,30000000,87044645,106030660,193075305,163075305,543.58435,Comedy,6.0,118.0
57,"Dec 18, 2015",Sisters,30000000,87044645,106030660,193075305,163075305,543.58435,Drama,5.7,84.0
61,"Jun 25, 2004",The Notebook,30000000,81001787,116025023,197026810,167026810,556.7560333333333,"Drama,War",7.0,112.0
69,"Sep 28, 2012",Looper,30000000,66486205,170466405,236952610,206952610,689.8420333333333,"Action,Crime,Drama",7.4,113.0
70,"Feb 1, 2013",Warm Bodies,30000000,66380662,115121608,181502270,151502270,505.00756666666666,"Comedy,Horror,Romance",6.9,98.0
72,"Jan 17, 2014",The Nut Job,30000000,64251538,122529966,186781504,156781504,522.6050133333333,"Adventure,Animation,Comedy",5.7,85.0
73,"Feb 16, 2001",Down to Earth,30000000,64172251,71172251,135344502,105344502,351.14834,"Adventure,Documentary",6.6,90.0
75,"Aug 8, 2012",Hope Springs,30000000,63536011,133085295,196621306,166621306,555.4043533333333,"Comedy,Drama,Romance",6.3,100.0
81,"Jan 9, 2009",Bride Wars,30000000,58715510,115150424,173865934,143865934,479.55311333333333,Comedy,4.4,90.0
83,"May 20, 2011",Midnight in Paris,30000000,56816662,162502774,219319436,189319436,631.0647866666667,"Comedy,Fantasy,Romance",7.7,94.0
84,"Nov 22, 2017",Darkest Hour,30000000,56443120,150807172,207250292,177250292,590.8343066666666,"Biography,Drama,History",7.4,125.0
88,"May 11, 2018",Life of the Party,30000000,53059911,65759911,118819822,88819822,296.06607333333335,"Comedy,Drama",7.6,84.0
88,"May 11, 2018",Life of the Party,30000000,53059911,65759911,118819822,88819822,296.06607333333335,Comedy,5.5,105.0
89,"May 14, 2010",Letters to Juliet,30000000,53032453,82148538,135180991,105180991,350.6033033333333,"Adventure,Comedy,Drama",6.6,105.0
92,"Jul 24, 2015",Southpaw,30000000,52421953,94156456,146578409,116578409,388.59469666666666,"Drama,Sport",7.4,124.0
94,"Jul 28, 2017",Atomic Blonde,30000000,51573925,98345423,149919348,119919348,399.73116000000005,"Action,Mystery,Thriller",6.7,115.0
100,"Sep 18, 2015",Sicario,30000000,46889293,84393749,131283042,101283042,337.61014,"Action,Crime,Drama",7.6,121.0
3,"Jan 19, 2018",Den of Thieves,30000000,44947622,80131391,125079013,95079013,316.93004333333334,"Action,Crime,Drama",7.0,140.0
4,"Apr 13, 2012",The Three Stooges,30000000,44338224,54052249,98390473,68390473,227.96824333333333,"Comedy,Family",5.1,92.0
6,"Oct 24, 2014",John Wick,30000000,43037835,76235001,119272836,89272836,297.57612,"Action,Crime,Thriller",7.4,101.0
8,"Apr 24, 2015",The Age of Adaline,30000000,42629776,68984536,111614312,81614312,272.04770666666667,"Drama,Fantasy,Romance",7.2,112.0
9,"Aug 6, 2010",Step Up 3D,30000000,42400223,165889117,208289340,178289340,594.2978,"Drama,Music,Romance",6.2,107.0
11,"Apr 13, 2012",The Cabin in the Woods,30000000,42073277,70689968,112763245,82763245,275.8774833333333,Horror,7.0,95.0
14,"Apr 8, 2011",Hanna,30000000,40259119,65343694,105602813,75602813,252.00937666666667,"Action,Drama,Thriller",6.8,111.0
22,"Sep 13, 2013",The Family,30000000,36918811,51078541,87997352,57997352,193.32450666666668,"Horror,Thriller",5.0,88.0
22,"Sep 13, 2013",The Family,30000000,36918811,51078541,87997352,57997352,193.32450666666668,"Comedy,Crime,Thriller",6.3,111.0
22,"Sep 13, 2013",The Family,30000000,36918811,51078541,87997352,57997352,193.32450666666668,"Comedy,Crime,Drama",7.5,152.0
22,"Sep 13, 2013",The Family,30000000,36918811,51078541,87997352,57997352,193.32450666666668,Drama,8.6,280.0
22,"Sep 13, 2013",The Family,30000000,36918811,51078541,87997352,57997352,193.32450666666668,"Documentary,Drama",7.6,106.0
22,"Sep 13, 2013",The Family,30000000,36918811,51078541,87997352,57997352,193.32450666666668,Drama,6.6,82.0
23,"Feb 9, 2018",The 15:17 to Paris,30000000,36276286,56096200,92372486,62372486,207.90828666666664,"Biography,Drama,Thriller",5.2,94.0
25,"Jul 1, 2011",Larry Crowne,30000000,35608245,61449135,97057380,67057380,223.52460000000002,"Comedy,Drama,Romance",6.1,98.0
26,"Oct 18, 2013",Carrie,30000000,35266619,82409520,117676139,87676139,292.2537966666667,"Drama,Horror",5.9,100.0
28,"Mar 2, 2018",Death Wish,30000000,34017028,48575965,82592993,52592993,175.30997666666664,"Action,Crime,Drama",6.4,107.0
30,"Jun 3, 2015",Entourage,30000000,32363404,46438538,78801942,48801942,162.67314,Comedy,6.6,104.0
32,"Feb 8, 2013",Side Effects,30000000,32172757,66742138,98914895,68914895,229.71631666666664,"Crime,Drama,Mystery",7.1,106.0
34,"Jul 2, 2014",Deliver Us from Evil,30000000,30577122,87956618,118533740,88533740,295.1124666666667,"Horror,Mystery,Thriller",6.2,118.0
35,"Aug 1, 2014",Get on Up,30000000,30569935,33339868,63909803,33909803,113.03267666666667,"Biography,Drama,Music",6.9,139.0
37,"Apr 27, 2012",The Five-Year Engagement,30000000,28700285,61623819,90324104,60324104,201.08034666666668,"Comedy,Romance",6.2,124.0
39,"Jul 15, 2011",Winnie the Pooh,30000000,26692846,50145607,76838453,46838453,156.12817666666666,"Adventure,Animation,Comedy",7.2,63.0
42,"Sep 14, 2018",White Boy Rick,30000000,24004833,25947983,49952816,19952816,66.50938666666667,"Crime,Drama",6.4,111.0
43,"Aug 4, 1995",Virtuosity,30000000,23998226,23998226,47996452,17996452,59.98817333333333,"Biography,Documentary,Music",7.7,87.0
45,"Feb 4, 2011",Sanctum,30000000,23209310,108957098,132166408,102166408,340.5546933333334,"Adventure,Drama,Thriller",5.9,108.0
47,"Aug 25, 2017",Ballerina,30000000,21858070,96892829,118750899,88750899,295.83633,"Biography,Documentary",7.5,50.0
49,"Nov 19, 2010",The Next Three Days,30000000,21148651,67255916,88404567,58404567,194.68189,"Action,Crime,Drama",7.4,133.0
50,"Jan 12, 2018",Proud Mary,30000000,20868638,21709539,42578177,12578177,41.927256666666665,"Action,Crime,Drama",4.9,89.0
53,"Oct 4, 2013",Runner Runner,30000000,19316646,60512680,79829326,49829326,166.09775333333334,"Crime,Thriller",5.6,88.0
55,"Apr 28, 2017",Baahubali 2: The Conclusion,30000000,18985794,263502914,282488708,252488708,841.6290266666667,"Action,Drama",8.3,167.0
58,"Aug 19, 2011",Fright Night,30000000,18298649,40520649,58819298,28819298,96.06432666666666,"Comedy,Horror",6.4,106.0
60,"Oct 9, 2015",Steve Jobs,30000000,17766658,35579007,53345665,23345665,77.81888333333333,"Biography,Drama",7.2,122.0
69,"Apr 30, 2004",Godsend,30000000,14334645,16910708,31245353,1245353,4.151176666666666,Drama,6.4,107.0
72,"Dec 25, 2005",The New World,30000000,12712093,26184400,38896493,8896493,29.654976666666666,Documentary,7.2,88.0
72,"Dec 25, 2005",The New World,30000000,12712093,26184400,38896493,8896493,29.654976666666666,Drama,5.1,90.0
74,"Jan 18, 2013",The Last Stand,30000000,12050299,48330757,60381056,30381056,101.27018666666667,"Action,Thriller",6.4,107.0
78,"Mar 8, 2013",Dead Man Down,30000000,10895295,19599974,30495269,495269,1.6508966666666667,"Action,Crime,Drama",6.5,118.0
82,"Apr 14, 2017",The Lost City of Z,30000000,8574339,17121823,25696162,-4303838,-14.346126666666667,"Adventure,Biography,Drama",6.6,141.0
84,"Feb 3, 2017",The Space Between Us,30000000,7885294,16481405,24366699,-5633301,-18.77767,"Adventure,Drama,Romance",6.4,120.0
86,"Jan 14, 2011",Barney's Version,30000000,7502560,8845575,16348135,-13651865,-45.50621666666667,"Comedy,Drama",7.3,134.0
87,"Sep 20, 2002",Trapped,30000000,6916869,6916869,13833738,-16166262,-53.88754,"Adventure,Drama,Thriller",5.0,92.0
87,"Sep 20, 2002",Trapped,30000000,6916869,6916869,13833738,-16166262,-53.88754,Horror,3.5,75.0
87,"Sep 20, 2002",Trapped,30000000,6916869,6916869,13833738,-16166262,-53.88754,"Drama,Thriller",6.5,102.0
87,"Sep 20, 2002",Trapped,30000000,6916869,6916869,13833738,-16166262,-53.88754,"Drama,Mystery,Thriller",8.4,56.0
87,"Sep 20, 2002",Trapped,30000000,6916869,6916869,13833738,-16166262,-53.88754,Documentary,7.0,90.0
87,"Sep 20, 2002",Trapped,30000000,6916869,6916869,13833738,-16166262,-53.88754,"Action,Drama,Thriller",7.6,105.0
88,"Aug 31, 2018",Kin,30000000,5718096,10096821,15814917,-14185083,-47.283609999999996,"Drama,Music",8.6,45.0
88,"Aug 31, 2018",Kin,30000000,5718096,10096821,15814917,-14185083,-47.283609999999996,"Action,Drama,Sci-Fi",5.7,102.0
90,"Sep 22, 2017",Stronger,30000000,4211129,8786752,12997881,-17002119,-56.67373,"Biography,Drama",7.0,119.0
90,"Sep 22, 2017",Stronger,30000000,4211129,8786752,12997881,-17002119,-56.67373,Drama,6.8,125.0
90,"Sep 22, 2017",Stronger,30000000,4211129,8786752,12997881,-17002119,-56.67373,"Action,Sport",8.4,47.0
91,"Jan 22, 1999",Gloria,30000000,4167493,4967493,9134986,-20865014,-69.55004666666666,"Comedy,Drama,Romance",6.8,110.0
91,"Jan 22, 1999",Gloria,30000000,4167493,4967493,9134986,-20865014,-69.55004666666666,"Biography,Drama,Music",6.5,126.0
99,"Sep 23, 2011",Machine Gun Preacher,30000000,538690,3721988,4260678,-25739322,-85.79774,"Action,Biography,Crime",6.8,129.0
100,"Feb 2, 2018",Bilal: A New Breed of Hero,30000000,490973,648599,1139572,-28860428,-96.20142666666666,"Action,Adventure,Animation",8.0,105.0
5,"Jan 30, 2015",Wild Card,30000000,3200,4315789,4318989,-25681011,-85.60337,"Action,Crime,Drama",5.6,92.0
6,"Jun 5, 2015",United Passions,30000000,918,168832,169750,-29830250,-99.43416666666667,"Drama,History,Sport",2.1,110.0
8,"Dec 1, 2015",Grace of Monaco,30000000,0,25199891,25199891,-4800109,-16.000363333333333,"Biography,Drama,Romance",5.7,103.0
11,"Dec 31, 2013",Space Pirate Captain Harlock,30000000,0,310985,310985,-29689015,-98.96338333333333,"Animation,Sci-Fi",7.1,100.0
13,"Feb 24, 2017",Collide,29200000,2280004,5466698,7746702,-21453298,-73.47019863013699,"Action,Crime,Thriller",5.7,99.0
14,"May 15, 2015",Pitch Perfect 2,29000000,184296230,287625468,471921698,442921698,1527.3162,"Comedy,Music",6.4,115.0
16,"Sep 28, 2018",Night School,29000000,77339130,103008792,180347922,151347922,521.8893862068965,Documentary,7.2,85.0
16,"Sep 28, 2018",Night School,29000000,77339130,103008792,180347922,151347922,521.8893862068965,Comedy,5.6,111.0
17,"Apr 8, 2016",The Boss,29000000,63077560,78652207,141729767,112729767,388.7233344827586,Comedy,5.4,99.0
21,"Aug 18, 2017",Logan Lucky,29000000,27778642,44264271,72042913,43042913,148.42383793103448,"Comedy,Crime,Drama",7.0,118.0
22,"Aug 12, 2016",Florence Foster Jenkins,29000000,27383770,56000339,83384109,54384109,187.53141034482758,"Biography,Comedy,Drama",6.8,111.0
30,"Sep 30, 2019",Unhinged,29000000,0,0,0,-29000000,-100.0,Horror,4.2,93.0
33,"Nov 11, 1992",Aladdin,28000000,217350219,504050219,721400438,693400438,2476.4301357142854,"Adventure,Comedy,Family",7.4,128.0
35,"Aug 14, 2015",Straight Outta Compton,28000000,161197785,202182981,363380766,335380766,1197.78845,"Biography,Drama,History",7.9,147.0
36,"Jul 21, 2017",Girls Trip,28000000,115108515,140886353,255994868,227994868,814.2673857142856,"Comedy,Drama",6.2,122.0
40,"Nov 1, 2017",A Bad Moms Christmas,28000000,72110659,127710550,199821209,171821209,613.6471750000001,"Adventure,Comedy",5.5,104.0
41,"Feb 14, 2013",Safe Haven,28000000,71399120,94050951,165450071,137450071,490.89311071428574,"Drama,Romance,Thriller",6.7,115.0
42,"Dec 11, 2015",The Big Short,28000000,70259870,133162752,203422622,175422622,626.5093642857142,"Biography,Comedy,Drama",7.8,130.0
43,"Nov 7, 2008",Role Models,28000000,67300955,94500826,161801781,133801781,477.8635035714285,"Comedy,Drama",4.9,132.0
44,"Oct 10, 2014","Alexander and the Terrible, Horrible, No Good, Very Bad Day",28000000,66954149,101379287,168333436,140333436,501.1908428571428,"Comedy,Family",6.2,81.0
45,"Feb 6, 2004",Miracle,28000000,64378093,64474705,128852798,100852798,360.1885642857143,Drama,5.8,78.0
45,"Feb 6, 2004",Miracle,28000000,64378093,64474705,128852798,100852798,360.1885642857143,Drama,7.0,100.0
45,"Feb 6, 2004",Miracle,28000000,64378093,64474705,128852798,100852798,360.1885642857143,"Comedy,Drama",7.0,91.0
46,"Jan 28, 2013",Last Vegas,28000000,63914167,112914167,176828334,148828334,531.5297642857142,"Comedy,Drama",6.6,105.0
50,"Jun 15, 2018",Tag,28000000,54730625,77026186,131756811,103756811,370.5600392857143,Drama,4.6,91.0
50,"Jun 15, 2018",Tag,28000000,54730625,77026186,131756811,103756811,370.5600392857143,Comedy,6.5,100.0
50,"Jun 15, 2018",Tag,28000000,54730625,77026186,131756811,103756811,370.5600392857143,"Action,Fantasy,Horror",6.1,85.0
52,"Apr 25, 2003",Identity,28000000,52131264,82183683,134314947,106314947,379.6962392857143,"Crime,Drama",6.6,93.0
53,"Oct 5, 2001",Serendipity,28000000,50255310,77477297,127732607,99732607,356.1878821428571,Drama,8.8,107.0
54,"Apr 16, 2010",Kick-Ass,28000000,48071303,97531134,145602437,117602437,420.00870357142855,"Action,Comedy",7.6,117.0
60,"Aug 12, 2011",30 Minutes or Less,28000000,37053924,40966716,78020640,50020640,178.64514285714284,"Action,Comedy,Crime",6.1,83.0
64,"Feb 21, 2014",3 Days to Kill,28000000,30697999,38959900,69657899,41657899,148.7782107142857,"Action,Drama,Thriller",6.2,117.0
65,"Aug 16, 2013",Kick-Ass 2,28000000,28795985,63129909,91925894,63925894,228.3067642857143,"Action,Comedy,Crime",6.6,103.0
67,"Sep 19, 2014",A Walk Among the Tombstones,28000000,26017685,62108587,88126272,60126272,214.7366857142857,"Action,Crime,Drama",6.5,114.0
68,"Jan 15, 2010",The Spy Next Door,28000000,24307106,46752858,71059964,43059964,153.7855857142857,"Action,Comedy,Family",5.5,94.0
69,"Apr 25, 2014",Brick Mansions,28000000,20396829,73421224,93818053,65818053,235.064475,"Action,Crime",5.7,90.0
72,"Aug 21, 2015",American Ultra,28000000,14439985,30295028,44735013,16735013,59.76790357142857,"Action,Comedy,Sci-Fi",6.1,96.0
74,"Feb 5, 2016",Pride and Prejudice and Zombies,28000000,10907291,16638300,27545591,-454409,-1.6228892857142858,"Action,Comedy,Horror",5.8,108.0
86,"Jan 13, 2012",Joyful Noise,27500000,30932113,31157914,62090027,34590027,125.78191636363636,"Comedy,Drama,Music",5.8,118.0
90,"Oct 28, 2011",Anonymous,27500000,4463292,15815509,20278801,-7221199,-26.258905454545456,"Drama,Thriller",6.9,130.0
91,"Mar 18, 2011",Limitless,27000000,79249455,155564919,234814374,207814374,769.6828666666667,"Mystery,Sci-Fi,Thriller",7.4,105.0
91,"Mar 18, 2011",Limitless,27000000,79249455,155564919,234814374,207814374,769.6828666666667,"Biography,Documentary",6.7,3.0
91,"Mar 18, 2011",Limitless,27000000,79249455,155564919,234814374,207814374,769.6828666666667,Documentary,3.9,57.0
96,"Dec 25, 1994",The Jungle Book,27000000,44342956,44342956,88685912,61685912,228.46634074074075,Animation,7.0,64.0
96,"Dec 25, 1994",The Jungle Book,27000000,44342956,44342956,88685912,61685912,228.46634074074075,"Adventure,Drama,Family",7.4,106.0
98,"May 13, 2016",Money Monster,27000000,41012075,93466095,134478170,107478170,398.06729629629626,"Crime,Drama,Thriller",6.5,98.0
14,"Nov 24, 1999",Flawless,27000000,4485485,4485485,8970970,-18029030,-66.77418518518519,Drama,6.4,97.0
28,"Aug 10, 1990",Flatliners,26000000,61308153,61308153,122616306,96616306,371.60117692307693,"Drama,Horror,Mystery",5.2,109.0
30,"Aug 19, 2005",Red Eye,26000000,57891803,96666486,154558289,128558289,494.4549576923077,Horror,3.3,73.0
33,"Apr 26, 2013",Pain & Gain,26000000,49875291,81275291,131150582,105150582,404.4253153846154,"Action,Comedy,Crime",6.4,129.0
37,"Jan 22, 2010",Legion,26000000,40168080,67647574,107815654,81815654,314.6755923076923,"Action,Fantasy,Horror",5.2,100.0
38,"Aug 29, 2012",Lawless,26000000,37397291,54393687,91790978,65790978,253.04222307692305,"Crime,Drama",7.3,116.0
41,"Dec 4, 2009",Brothers,26000000,28544157,45043870,73588027,47588027,183.0308730769231,Drama,5.8,90.0
41,"Dec 4, 2009",Brothers,26000000,28544157,45043870,73588027,47588027,183.0308730769231,Documentary,7.7,100.0
41,"Dec 4, 2009",Brothers,26000000,28544157,45043870,73588027,47588027,183.0308730769231,"Action,Drama,Sport",6.7,156.0
41,"Dec 4, 2009",Brothers,26000000,28544157,45043870,73588027,47588027,183.0308730769231,Documentary,7.5,68.0
41,"Dec 4, 2009",Brothers,26000000,28544157,45043870,73588027,47588027,183.0308730769231,Drama,7.6,93.0
41,"Dec 4, 2009",Brothers,26000000,28544157,45043870,73588027,47588027,183.0308730769231,"Action,Drama,War",5.2,95.0
42,"Oct 17, 2014",The Best of Me,26000000,26766213,41059418,67825631,41825631,160.86781153846155,"Drama,Romance",6.7,118.0
44,"Aug 3, 2001",Original Sin,26000000,16521410,16521410,33042820,7042820,27.087769230769233,Comedy,7.7,75.0
45,"Apr 27, 2012",The Raven,26000000,16008272,30601801,46610073,20610073,79.26951153846153,"Crime,Mystery,Thriller",6.4,110.0
50,"Oct 18, 2013",The Fifth Estate,26000000,3254172,6154172,9408344,-16591656,-63.814061538461544,"Biography,Drama,Thriller",6.2,128.0
52,"Mar 21, 2014",Blood Ties,26000000,42472,2923959,2966431,-23033569,-88.59065000000001,"Action,Crime,Drama",6.5,127.0
52,"Mar 21, 2014",Blood Ties,26000000,42472,2923959,2966431,-23033569,-88.59065000000001,"Documentary,Drama,Family",7.0,83.0
54,"Jun 30, 2015",Viy,26000000,0,34246770,34246770,8246770,31.718346153846156,"Adventure,Fantasy,Mystery",5.3,127.0
55,"Mar 17, 2015",Accidental Love,26000000,0,135436,135436,-25864564,-99.47909230769231,"Comedy,Romance",4.1,100.0
56,"Apr 24, 2015",The Face of an Angel,26000000,0,0,0,-26000000,-100.0,"Crime,Drama",4.6,101.0
63,"Aug 10, 2011",The Help,25000000,169705587,213120004,382825591,357825591,1431.3023640000001,Drama,8.1,146.0
64,"Dec 25, 2016",Hidden Figures,25000000,169607287,231771716,401379003,376379003,1505.516012,"Biography,Drama,History",7.8,127.0
67,"Jan 17, 2014",Ride Along,25000000,134202565,153733800,287936365,262936365,1051.74546,"Action,Comedy,Crime",6.2,99.0
67,"Jan 17, 2014",Ride Along,25000000,134202565,153733800,287936365,262936365,1051.74546,Action,4.4,87.0
68,"Nov 25, 1992",The Bodyguard,25000000,121945720,410899039,532844759,507844759,2031.3790359999998,Drama,8.3,99.0
77,"Feb 5, 2010",Dear John,25000000,80014842,142033509,222048351,197048351,788.193404,"Drama,Romance,War",6.3,108.0
79,"Dec 25, 2012",Parental Guidance,25000000,77267296,120832383,198099679,173099679,692.398716,"Comedy,Family",6.1,105.0
83,"Dec 15, 2000",Chocolat,25000000,71309760,152500343,223810103,198810103,795.240412,"Biography,Drama",7.0,119.0
84,"Jan 21, 2011",No Strings Attached,25000000,70662220,149228078,219890298,194890298,779.561192,"Comedy,Romance",6.2,108.0
85,"Jan 13, 2012",Contraband,25000000,66528000,98406855,164934855,139934855,559.73942,"Action,Crime,Drama",6.5,109.0
87,"Apr 20, 2012",The Lucky One,25000000,60457138,96633833,157090971,132090971,528.363884,"Drama,Romance",6.5,101.0
92,"Apr 22, 2011",Madea's Big Happy Family,25000000,53345287,54160818,107506105,82506105,330.02441999999996,"Comedy,Drama",4.7,106.0
95,"Jan 27, 2012",The Grey,25000000,51580136,81249176,132829312,107829312,431.31724800000006,"Action,Adventure,Drama",6.8,117.0
96,"Jan 28, 2005",Hide and Seek,25000000,51100486,123696741,174797227,149797227,599.188908,"Action,Horror,Mystery",6.4,107.0
96,"Jan 28, 2005",Hide and Seek,25000000,51100486,123696741,174797227,149797227,599.188908,"Comedy,Crime",5.9,118.0
96,"Jan 28, 2005",Hide and Seek,25000000,51100486,123696741,174797227,149797227,599.188908,"Mystery,Thriller",5.9,105.0
96,"Jan 28, 2005",Hide and Seek,25000000,51100486,123696741,174797227,149797227,599.188908,Comedy,6.6,91.0
2,"Aug 15, 2014",The Giver,25000000,45090374,66540205,111630579,86630579,346.522316,"Drama,Romance,Sci-Fi",6.5,97.0
6,"Nov 20, 2015",The Night Before,25000000,43035725,52427346,95463071,70463071,281.852284,"Adventure,Comedy,Fantasy",6.4,101.0
6,"Nov 20, 2015",The Night Before,25000000,43035725,52427346,95463071,70463071,281.852284,Horror,4.7,81.0
15,"Dec 25, 2013",August: Osage County,25000000,37738810,50738810,88477620,63477620,253.91048,"Comedy,Drama",7.2,121.0
17,"May 16, 2014",Million Dollar Arm,25000000,36447959,39217912,75665871,50665871,202.66348399999998,"Biography,Drama,Sport",7.0,124.0
21,"Sep 7, 2018",Peppermint,25000000,35418723,51800758,87219481,62219481,248.877924,"Action,Crime,Drama",6.5,101.0
22,"Sep 21, 2007",Good Luck Chuck,25000000,35017297,59183821,94201118,69201118,276.804472,Comedy,7.4,51.0
25,"Dec 10, 2014",The Gambler,25000000,33680992,38718031,72399023,47399023,189.596092,Drama,7.0,105.0
25,"Dec 10, 2014",The Gambler,25000000,33680992,38718031,72399023,47399023,189.596092,"Crime,Drama,Thriller",6.0,111.0
25,"Dec 10, 2014",The Gambler,25000000,33680992,38718031,72399023,47399023,189.596092,Documentary,7.6,52.0
25,"Dec 10, 2014",The Gambler,25000000,33680992,38718031,72399023,47399023,189.596092,"Drama,Thriller",7.2,109.0
25,"Dec 10, 2014",The Gambler,25000000,33680992,38718031,72399023,47399023,189.596092,"Action,Sci-Fi,Thriller",6.1,121.0
29,"Feb 17, 2017",Fist Fight,25000000,32187017,40286416,72473433,47473433,189.893732,Comedy,5.6,91.0
32,"Dec 9, 2011",The Sitter,25000000,30542576,38749404,69291980,44291980,177.16791999999998,Comedy,5.7,81.0
32,"Dec 9, 2011",The Sitter,25000000,30542576,38749404,69291980,44291980,177.16791999999998,Horror,4.0,97.0
36,"Apr 11, 2014",Draft Day,25000000,28842237,29847480,58689717,33689717,134.758868,"Drama,Sport",6.8,110.0
38,"Feb 3, 2017",Rings,25000000,27793018,82917283,110710301,85710301,342.841204,"Drama,Horror,Mystery",4.5,102.0
43,"Aug 26, 2011",Don't Be Afraid of the Dark,25000000,24046682,39126427,63173109,38173109,152.692436,"Fantasy,Horror,Thriller",5.6,99.0
44,"Apr 23, 2010",The Losers,25000000,23591432,29863840,53455272,28455272,113.82108799999999,"Action,Adventure,Crime",6.4,97.0
44,"Apr 23, 2010",The Losers,25000000,23591432,29863840,53455272,28455272,113.82108799999999,Drama,1.7,112.0
46,"Aug 24, 2007",War,25000000,22486409,40686409,63172818,38172818,152.691272,Drama,6.8,106.0
50,"Feb 11, 2011",The Eagle,25000000,19490041,38993548,58483589,33483589,133.934356,"Action,Adventure,Drama",6.2,114.0
52,"Sep 2, 2011",Shark Night 3D,25000000,18877153,18877153,37754306,12754306,51.017224000000006,"Horror,Thriller",4.0,90.0
56,"Dec 22, 2017",Father Figures,25000000,17501244,21038441,38539685,13539685,54.15874000000001,"Adventure,Comedy,Drama",5.5,113.0
56,"Dec 22, 2017",Father Figures,25000000,17501244,21038441,38539685,13539685,54.15874000000001,Documentary,6.8,58.0
58,"Oct 25, 2013",The Counselor,25000000,16973715,71009334,87983049,62983049,251.932196,"Crime,Drama,Thriller",5.3,117.0
60,"Dec 7, 2018",Mary Queen of Scots,25000000,16468499,46734733,63203232,38203232,152.812928,"Biography,Drama,History",5.5,119.0
60,"Dec 7, 2018",Mary Queen of Scots,25000000,16468499,46734733,63203232,38203232,152.812928,"Biography,Drama,History",6.3,124.0
63,"Apr 18, 1986",Legend,25000000,15502112,23506237,39008349,14008349,56.033396,"Action,Drama",6.5,168.0
63,"Apr 18, 1986",Legend,25000000,15502112,23506237,39008349,14008349,56.033396,"Biography,Crime,Drama",7.0,132.0
66,"Nov 6, 2009",The Box,25000000,15051977,34356760,49408737,24408737,97.634948,Drama,6.3,89.0
68,"Oct 8, 2010",My Soul to Take,25000000,14744435,16727470,31471905,6471905,25.88762,"Horror,Mystery,Thriller",4.8,107.0
74,"Sep 9, 2011",Warrior,25000000,13657115,24215385,37872500,12872500,51.49,"Drama,Sport",8.2,140.0
76,"Sep 22, 2017",Battle of the Sexes,25000000,12638526,18445379,31083905,6083905,24.33562,"Biography,Comedy,Drama",6.7,121.0
77,"Dec 21, 2012",Cirque du Soleil: Worlds Away,25000000,12512862,28012862,40525724,15525724,62.102895999999994,Fantasy,6.8,91.0
78,"Nov 13, 2015",The 33,25000000,12227722,28400715,40628437,15628437,62.513748,"Biography,Drama,History",6.9,127.0
80,"Apr 15, 2011",The Conspirator,25000000,11538204,15907411,27445615,2445615,9.78246,"Crime,Drama,History",6.9,122.0
88,"Sep 16, 2011",Straw Dogs,25000000,10324441,11253821,21578262,-3421738,-13.686952,"Action,Drama,Thriller",5.8,110.0
90,"Aug 16, 2002",Possession,25000000,10103647,14805812,24909459,-90541,-0.36216400000000004,"Drama,Mystery",7.2,90.0
90,"Aug 16, 2002",Possession,25000000,10103647,14805812,24909459,-90541,-0.36216400000000004,Horror,5.4,80.0
90,"Aug 16, 2002",Possession,25000000,10103647,14805812,24909459,-90541,-0.36216400000000004,Drama,6.8,82.0
93,"Jan 25, 2019",Serenity,25000000,8547045,11367029,19914074,-5085926,-20.343704000000002,"Drama,Mystery,Sci-Fi",5.3,106.0
94,"Nov 25, 2009",The Road,25000000,8114270,29206732,37321002,12321002,49.284008,"Crime,Drama,Horror",5.6,110.0
94,"Nov 25, 2009",The Road,25000000,8114270,29206732,37321002,12321002,49.284008,Drama,5.4,102.0
94,"Nov 25, 2009",The Road,25000000,8114270,29206732,37321002,12321002,49.284008,Drama,5.5,96.0
94,"Nov 25, 2009",The Road,25000000,8114270,29206732,37321002,12321002,49.284008,Documentary,7.7,95.0
95,"Oct 12, 2018",Beautiful Boy,25000000,7634767,13031424,20666191,-4333809,-17.335236000000002,"Biography,Drama",7.3,120.0
95,"Oct 12, 2018",Beautiful Boy,25000000,7634767,13031424,20666191,-4333809,-17.335236000000002,Drama,6.6,100.0
97,"Mar 15, 2019",Captive State,25000000,5958315,8993300,14951615,-10048385,-40.19354,"Sci-Fi,Thriller",6.9,109.0
5,"Oct 3, 2008",Blindness,25000000,3073392,20052958,23126350,-1873650,-7.4946,Drama,5.4,115.0
6,"Apr 13, 2018",Sgt. Stubby: An American Hero,25000000,3054285,3645957,6700242,-18299758,-73.199032,"Adventure,Animation,Family",6.9,84.0
7,"Dec 16, 2011",Carnage,25000000,2546747,38112154,40658901,15658901,62.635604,"Comedy,Drama",7.2,80.0
7,"Dec 16, 2011",Carnage,25000000,2546747,38112154,40658901,15658901,62.635604,Comedy,7.8,68.0
8,"Sep 1, 2017",Tulip Fever,25000000,2455635,6792768,9248403,-15751597,-63.006388,"Drama,History,Romance",6.2,105.0
10,"Nov 20, 2015",Legend,25000000,1872994,42425450,44298444,19298444,77.193776,"Action,Drama",6.5,168.0
10,"Nov 20, 2015",Legend,25000000,1872994,42425450,44298444,19298444,77.193776,"Biography,Crime,Drama",7.0,132.0
12,"Jan 29, 2016",Jane Got a Gun,25000000,1513793,3771345,5285138,-19714862,-78.859448,"Action,Drama,Western",5.9,98.0
14,"Sep 16, 2005",Venom,25000000,881745,881745,1763490,-23236510,-92.94604,"Action,Sci-Fi,Thriller",6.7,112.0
14,"Sep 16, 2005",Venom,25000000,881745,881745,1763490,-23236510,-92.94604,Thriller,3.0,92.0
17,"Mar 22, 2013",On the Road,25000000,720828,9313302,10034130,-14965870,-59.86348,"Adventure,Drama,Romance",6.1,124.0
17,"Mar 22, 2013",On the Road,25000000,720828,9313302,10034130,-14965870,-59.86348,Drama,6.0,89.0
17,"Mar 22, 2013",On the Road,25000000,720828,9313302,10034130,-14965870,-59.86348,Drama,5.7,121.0
19,"Jun 30, 2010",Love Ranch,25000000,137885,146149,284034,-24715966,-98.863864,"Biography,Comedy,Drama",5.6,117.0
25,"Jul 8, 2011",Ironclad,25000000,0,5297411,5297411,-19702589,-78.810356,"Action,Adventure,Drama",6.2,121.0
26,"May 10, 2019",The Professor and the Madman,25000000,0,5227233,5227233,-19772767,-79.09106799999999,"Biography,Drama,Mystery",7.4,124.0
27,"Mar 10, 2015",Red Sky,25000000,0,91116,91116,-24908884,-99.635536,"Action,Thriller",4.1,100.0
27,"Mar 10, 2015",Red Sky,25000000,0,91116,91116,-24908884,-99.635536,Thriller,4.9,56.0
27,"Mar 10, 2015",Red Sky,25000000,0,91116,91116,-24908884,-99.635536,"Drama,War",4.1,91.0
29,"Jan 10, 2014",The Adventurer: The Curse of the Midas Box,25000000,0,0,0,-25000000,-100.0,"Adventure,Family,Fantasy",5.4,100.0
30,"Dec 31, 2019",Reagan,25000000,0,0,0,-25000000,-100.0,"Biography,Documentary",7.4,105.0
31,"Nov 9, 2012",Dangerous Liaisons,24200000,17000,10447579,10464579,-13735421,-56.75793801652893,"Drama,Mystery,Romance",5.9,110.0
36,"Jun 20, 2014",Think Like a Man Too,24000000,65028687,70027933,135056620,111056620,462.73591666666664,"Comedy,Romance",5.8,106.0
37,"Dec 16, 2016",Fences,24000000,57682904,64282881,121965785,97965785,408.1907708333334,Drama,7.2,139.0
39,"Oct 14, 2011",Footloose,24000000,51802742,62989834,114792576,90792576,378.30240000000003,"Comedy,Drama,Music",5.9,113.0
40,"Apr 7, 2017",Going in Style,24000000,45018541,78672579,123691120,99691120,415.37966666666665,"Comedy,Crime",6.6,96.0
41,"Jul 12, 1991",Point Break,24000000,43218387,83531958,126750345,102750345,428.1264375,"Action,Crime,Sport",5.3,114.0
44,"Nov 21, 2007",Hitman,24000000,39687694,99135571,138823265,114823265,478.43027083333334,Action,5.8,95.0
44,"Nov 21, 2007",Hitman,24000000,39687694,99135571,138823265,114823265,478.43027083333334,Action,4.9,147.0
52,"Aug 20, 2010",Piranha 3D,24000000,25003155,83660160,108663315,84663315,352.76381250000003,"Comedy,Horror",5.4,88.0
53,"Nov 24, 2010",Faster,24000000,23240020,35792945,59032965,35032965,145.9706875,"Action,Crime,Drama",6.5,98.0
58,"Sep 16, 2011",I Don't Know How She Does It,24000000,9659074,24474463,34133537,10133537,42.22307083333333,"Comedy,Romance",4.9,89.0
60,"Dec 20, 2013",Dhoom 3,24000000,8031955,11723620,19755575,-4244425,-17.685104166666665,"Action,Thriller",5.4,172.0
71,"Nov 16, 2018",Green Book,23000000,85080171,322034439,407114610,384114610,1670.0635217391305,"Biography,Comedy,Drama",8.3,130.0
73,"Jan 16, 2015",The Wedding Ringer,23000000,64460211,80171596,144631807,121631807,528.8339434782608,Comedy,6.7,101.0
74,"Mar 17, 2000",Final Destination,23000000,53302314,112036870,165339184,142339184,618.8660173913044,Documentary,6.1,65.0
76,"Oct 7, 2011",The Ides of March,23000000,40962534,77735925,118698459,95698459,416.08025652173916,"Drama,Thriller",7.1,101.0
78,"Oct 5, 2018",The Hate U Give,23000000,29719483,35067665,64787148,41787148,181.68325217391305,"Crime,Drama",7.3,133.0
80,"Jan 10, 2014",Her,23000000,25568251,48163815,73732066,50732066,220.5742,"Drama,Romance,Sci-Fi",8.0,126.0
83,"Jan 20, 2012",Haywire,23000000,18942396,36374700,55317096,32317096,140.50911304347827,"Action,Drama,Thriller",5.8,93.0
86,"Feb 26, 2016",Eddie the Eagle,23000000,15789389,45060480,60849869,37849869,164.56464782608694,"Biography,Comedy,Drama",7.4,106.0
88,"Aug 25, 2000",The Crew,23000000,13019253,13019253,26038506,3038506,13.210895652173912,"Crime,Drama,Thriller",6.3,81.0
97,"Jun 28, 2013",Redemption,23000000,36686,13593473,13630159,-9369841,-40.738439130434784,"Adventure,Drama,Romance",4.5,97.0
97,"Jun 28, 2013",Redemption,23000000,36686,13593473,13630159,-9369841,-40.738439130434784,"Action,Crime,Drama",6.2,100.0
97,"Jun 28, 2013",Redemption,23000000,36686,13593473,13630159,-9369841,-40.738439130434784,"Family,Horror,Romance",4.6,110.0
97,"Jun 28, 2013",Redemption,23000000,36686,13593473,13630159,-9369841,-40.738439130434784,"Drama,Mystery,Thriller",8.4,106.0
97,"Jun 28, 2013",Redemption,23000000,36686,13593473,13630159,-9369841,-40.738439130434784,Drama,7.2,104.0
98,"Apr 25, 2008",Rogue,23000000,10452,4673377,4683829,-18316171,-79.63552608695652,"Action,Romance,Thriller",5.8,134.0
3,"Nov 18, 2016",Nocturnal Animals,22500000,10663357,32398681,43062038,20562038,91.38683555555556,"Drama,Thriller",7.5,116.0
4,"Apr 24, 2015",The Water Diviner,22500000,4200117,31054727,35254844,12754844,56.68819555555555,"Drama,History,War",7.1,111.0
5,"Jul 13, 1990",Ghost,22000000,217631306,517600000,735231306,713231306,3241.9604818181815,"Drama,Fantasy,Mystery",5.8,115.0
5,"Jul 13, 1990",Ghost,22000000,217631306,517600000,735231306,713231306,3241.9604818181815,Horror,2.3,118.0
11,"Feb 28, 2014",Son of God,22000000,59700064,70949793,130649857,108649857,493.86298636363637,Documentary,6.8,80.0
11,"Feb 28, 2014",Son of God,22000000,59700064,70949793,130649857,108649857,493.86298636363637,"Biography,Drama,History",5.8,138.0
13,"Aug 8, 2014",The Hundred-Foot Journey,22000000,54235441,94270488,148505929,126505929,575.0269499999999,"Comedy,Drama",7.3,122.0
16,"Jul 28, 1995",The Net,22000000,50621733,110521733,161143466,139143466,632.4703000000001,Drama,7.3,114.0
16,"Jul 28, 1995",The Net,22000000,50621733,110521733,161143466,139143466,632.4703000000001,Drama,5.3,75.0
17,"Aug 3, 2012",Diary of a Wimpy Kid: Dog Days,22000000,49008662,77229695,126238357,104238357,473.81071363636363,"Comedy,Family",6.3,94.0
19,"Nov 11, 2005",Derailed,22000000,36020063,57520063,93540126,71540126,325.18239090909094,"Action,Crime",6.3,107.0
21,"Nov 22, 2013",Delivery Man,22000000,30659817,70536870,101196687,79196687,359.9849409090909,"Comedy,Drama",6.4,105.0
22,"Feb 5, 2016","Hail, Caesar!",22000000,30080225,64160680,94240905,72240905,328.36775,"Comedy,Drama,Music",6.3,106.0
27,"May 19, 2017",Diary of a Wimpy Kid: The Long Haul,22000000,20738724,35609577,56348301,34348301,156.1286409090909,"Comedy,Family",4.4,91.0
29,"Nov 27, 2013",Homefront,22000000,20158492,51695362,71853854,49853854,226.60842727272725,"Action,Thriller",6.5,100.0
29,"Nov 27, 2013",Homefront,22000000,20158492,51695362,71853854,49853854,226.60842727272725,Drama,7.7,111.0
33,"Sep 14, 2001",The Glass House,22000000,17951431,22861785,40813216,18813216,85.51461818181818,"Drama,Thriller",7.4,95.0
34,"Sep 4, 2015",The Transporter Refueled,22000000,16029670,69698495,85728165,63728165,289.67347727272727,"Action,Adventure,Crime",5.2,96.0
35,"Jun 13, 1980",The Island,22000000,15716828,15716828,31433656,9433656,42.88025454545454,"Drama,Romance",5.1,95.0
35,"Jun 13, 1980",The Island,22000000,15716828,15716828,31433656,9433656,42.88025454545454,"Comedy,Drama",6.2,134.0
37,"Aug 22, 2012",Hit & Run,22000000,13749300,17216955,30966255,8966255,40.75570454545455,"Action,Comedy",7.1,114.0
40,"Nov 17, 2017","Roman J. Israel, Esq.",22000000,11962712,12967012,24929724,2929724,13.316927272727272,"Crime,Drama,Thriller",6.4,122.0
41,"Dec 4, 2013",Out of the Furnace,22000000,11330849,15434375,26765224,4765224,21.660109090909092,"Crime,Drama,Thriller",6.8,116.0
44,"Dec 8, 2017",Just Getting Started,22000000,6069605,6756412,12826017,-9173983,-41.69992272727273,"Action,Comedy",4.4,91.0
49,"Oct 31, 2014",Before I Go to Sleep,22000000,3242457,19563579,22806036,806036,3.6637999999999997,"Drama,Horror,Mystery",6.3,92.0
50,"Oct 8, 2010",Stone,22000000,1810078,4065020,5875098,-16124902,-73.29500909090909,"Drama,Thriller",5.4,105.0
50,"Oct 8, 2010",Stone,22000000,1810078,4065020,5875098,-16124902,-73.29500909090909,"Crime,Drama,Thriller",5.6,90.0
58,"Jun 22, 2012",To Rome with Love,21500000,16684352,74326015,91010367,69510367,323.30403255813957,"Comedy,Music,Romance",6.3,112.0
59,"Nov 16, 2012",Silver Linings Playbook,21000000,132092958,236412453,368505411,347505411,1654.7876714285715,"Comedy,Drama,Romance",7.7,122.0
60,"Apr 6, 2018",Blockers,21000000,60311495,94045328,154356823,133356823,635.0324904761906,Comedy,6.2,102.0
61,"Apr 5, 2019",Pet Sematary,21000000,54724696,109501146,164225842,143225842,682.027819047619,"Horror,Mystery,Thriller",6.0,101.0
64,"Apr 16, 2010",Death at a Funeral,21000000,42739347,48977233,91716580,70716580,336.7456190476191,Comedy,5.7,92.0
67,"Nov 5, 2010",For Colored Girls,21000000,37729698,38017873,75747571,54747571,260.70271904761904,Drama,6.1,133.0
69,"Aug 4, 2017",Kidnap,21000000,30718107,34836080,65554187,44554187,212.16279523809524,"Crime,Drama,Thriller",5.9,95.0
72,"Dec 9, 2011",Tinker Tailor Soldier Spy,21000000,24149393,81452811,105602204,84602204,402.8676380952381,"Drama,Mystery,Thriller",7.1,122.0
79,"May 6, 2011",The Beaver,21000000,970816,5046038,6016854,-14983146,-71.34831428571428,Drama,6.7,91.0
80,"Feb 24, 2017",Bitter Harvest,21000000,557241,606162,1163403,-19836597,-94.45998571428571,"Drama,Romance,War",6.1,103.0
81,"Oct 22, 1999",Molly,21000000,17396,17396,34792,-20965208,-99.83432380952381,"Action,Sci-Fi",4.6,91.0
82,"Feb 1, 2019",Velvet Buzzsaw,21000000,0,0,0,-21000000,-100.0,"Horror,Mystery,Thriller",5.7,113.0
85,"Aug 11, 2006",Pulse,20500000,20264436,30241435,50505871,30005871,146.3701024390244,"Drama,Fantasy,Sci-Fi",5.3,84.0
86,"Nov 13, 1991",Beauty and the Beast,20000000,376057266,608431132,984488398,964488398,4822.44199,"Drama,Fantasy,Romance",6.4,112.0
86,"Nov 13, 1991",Beauty and the Beast,20000000,376057266,608431132,984488398,964488398,4822.44199,"Family,Fantasy,Musical",7.2,129.0
88,"Mar 22, 2019",Us,20000000,175006930,254210310,429217240,409217240,2046.0862,Drama,5.3,92.0
88,"Mar 22, 2019",Us,20000000,175006930,254210310,429217240,409217240,2046.0862,Comedy,8.3,75.0
88,"Mar 22, 2019",Us,20000000,175006930,254210310,429217240,409217240,2046.0862,"Horror,Mystery,Thriller",7.1,116.0
92,"Dec 9, 2016",La La Land,20000000,151101803,426351163,577452966,557452966,2787.26483,"Comedy,Drama,Music",8.0,128.0
93,"Jul 19, 2013",The Conjuring,20000000,137400141,318000141,455400282,435400282,2177.0014100000003,"Horror,Mystery,Thriller",7.5,112.0
95,"Nov 17, 2017",Wonder,20000000,132422809,304604712,437027521,417027521,2085.137605,"Drama,Family",8.0,113.0
98,"Oct 15, 2010",Jackass 3D,20000000,117229692,171685793,288915485,268915485,1344.577425,"Action,Comedy,Documentary",7.0,95.0
99,"Jul 29, 2016",Bad Moms,20000000,113257297,180998716,294256013,274256013,1371.280065,Comedy,6.2,100.0
100,"Jan 18, 2019",Glass,20000000,111035005,245303505,356338510,336338510,1681.69255,"Drama,Mystery,Thriller",8.2,71.0
100,"Jan 18, 2019",Glass,20000000,111035005,245303505,356338510,336338510,1681.69255,"Crime,Horror,Mystery",3.4,77.0
100,"Jan 18, 2019",Glass,20000000,111035005,245303505,356338510,336338510,1681.69255,"Drama,Sci-Fi,Thriller",6.8,129.0
3,"Jul 2, 2014",Tammy,20000000,84525432,96407655,180933087,160933087,804.6654350000001,"Comedy,Romance",4.9,97.0
5,"Nov 16, 2011",The Descendants,20000000,82624961,175507800,258132761,238132761,1190.663805,"Comedy,Drama",7.3,115.0
5,"Nov 16, 2011",The Descendants,20000000,82624961,175507800,258132761,238132761,1190.663805,Drama,7.5,80.0
12,"Apr 24, 2009",Obsessed,20000000,68261644,73964713,142226357,122226357,611.131785,Drama,6.2,132.0
15,"Mar 31, 2010",The Last Song,20000000,62950384,92678948,155629332,135629332,678.14666,"Drama,Music,Romance",6.0,107.0
16,"Apr 2, 2010",Why Did I Get Married Too?,20000000,60095852,60831067,120926919,100926919,504.634595,"Comedy,Drama,Romance",4.6,121.0
18,"Oct 18, 2013",12 Years a Slave,20000000,56671993,181025343,237697336,217697336,1088.48668,"Biography,Drama,History",8.1,134.0
20,"Jun 3, 2016",Me Before You,20000000,56245075,208265198,264510273,244510273,1222.551365,"Drama,Romance",7.4,106.0
21,"Feb 8, 2019",What Men Want,20000000,54611903,69911903,124523806,104523806,522.61903,"Comedy,Fantasy,Romance",4.9,117.0
22,"Apr 15, 2016",Barbershop: The Next Cut,20000000,54030051,54404202,108434253,88434253,442.171265,"Comedy,Drama",5.9,111.0
24,"Sep 14, 2018",A Simple Favor,20000000,53548586,97628717,151177303,131177303,655.886515,"Comedy,Crime,Drama",6.9,117.0
25,"Jan 9, 2015",Selma,20000000,52076908,66776576,118853484,98853484,494.26742,"Biography,Drama,History",7.5,128.0
34,"Nov 6, 2015",Spotlight,20000000,45055776,92088460,137144236,117144236,585.72118,"Crime,Drama",8.1,129.0
34,"Nov 6, 2015",Spotlight,20000000,45055776,92088460,137144236,117144236,585.72118,Drama,8.0,99.0
35,"Mar 30, 2018",Acrimony,20000000,43549096,46627836,90176932,70176932,350.88466,"Drama,Romance,Thriller",5.7,120.0
36,"Jun 26, 2015",Max,20000000,42656255,43658157,86314412,66314412,331.57206,Comedy,5.1,83.0
36,"Jun 26, 2015",Max,20000000,42656255,43658157,86314412,66314412,331.57206,"Adventure,Drama,Family",6.8,111.0
38,"Jul 24, 2009",Orphan,20000000,41596251,78769428,120365679,100365679,501.828395,Drama,6.1,111.0
39,"Nov 17, 2017",The Star,20000000,40847995,62758010,103606005,83606005,418.030025,"Adventure,Animation,Comedy",6.1,86.0
43,"Jul 27, 2016",Nerve,20000000,38583626,70652284,109235910,89235910,446.17955,"Comedy,Drama",6.8,83.0
43,"Jul 27, 2016",Nerve,20000000,38583626,70652284,109235910,89235910,446.17955,"Drama,Mystery,Thriller",4.6,86.0
43,"Jul 27, 2016",Nerve,20000000,38583626,70652284,109235910,89235910,446.17955,"Action,Adventure,Crime",6.5,96.0
43,"Jul 27, 2016",Nerve,20000000,38583626,70652284,109235910,89235910,446.17955,"Documentary,History",6.2,62.0
44,"May 14, 1982",Conan the Barbarian,20000000,38264085,79114085,117378170,97378170,486.89085,"Action,Adventure,Fantasy",5.2,113.0
48,"Feb 19, 2016",Risen,20000000,36880033,46255763,83135796,63135796,315.67897999999997,"Biography,Drama",5.3,121.0
48,"Feb 19, 2016",Risen,20000000,36880033,46255763,83135796,63135796,315.67897999999997,"Action,Adventure,Drama",6.3,107.0
49,"Aug 18, 2010",Vampires Suck,20000000,36661504,81424988,118086492,98086492,490.43246,Comedy,3.4,82.0
50,"Dec 21, 1979",The Black Hole,20000000,35841901,35841901,71683802,51683802,258.41900999999996,"Sci-Fi,Thriller",2.8,111.0
51,"Sep 1, 2010",The American,20000000,35606376,67950723,103557099,83557099,417.785495,"Crime,Drama,Thriller",6.3,105.0
53,"Nov 4, 2011",A Very Harold & Kumar 3D Christmas,20000000,35061031,36265745,71326776,51326776,256.63388,"Adventure,Comedy",6.3,90.0
55,"Jan 4, 2013",Texas Chainsaw 3D,20000000,34341945,47666013,82007958,62007958,310.03979,"Horror,Thriller",4.8,92.0
60,"Oct 27, 1995",Copycat,20000000,32051917,32051917,64103834,44103834,220.51916999999997,Comedy,5.1,90.0
62,"Mar 12, 2010",She's Out of My League,20000000,32010860,48680977,80691837,60691837,303.459185,"Comedy,Romance",6.4,104.0
63,"Nov 26, 2008",Milk,20000000,31841299,57293371,89134670,69134670,345.67334999999997,"Documentary,Family",7.2,91.0
65,"Aug 31, 2011",The Debt,20000000,31177548,46604054,77781602,57781602,288.90801,"Drama,Thriller",6.9,113.0
65,"Aug 31, 2011",The Debt,20000000,31177548,46604054,77781602,57781602,288.90801,"Drama,Mystery,Thriller",6.1,99.0
76,"Aug 23, 2013",The World's End,20000000,26004851,47508505,73513356,53513356,267.56678,"Action,Comedy,Sci-Fi",7.0,109.0
78,"Sep 24, 2010",You Again,20000000,25702053,32838945,58540998,38540998,192.70499,"Comedy,Family,Romance",5.8,105.0
81,"Dec 25, 2018",On the Basis of Sex,20000000,24622687,38073377,62696064,42696064,213.48031999999998,"Biography,Drama",6.9,120.0
82,"Feb 14, 2014",Endless Love,20000000,23438250,34718173,58156423,38156423,190.782115,"Drama,Romance",6.3,104.0
83,"Sep 8, 2006",The Covenant,20000000,23364784,38164784,61529568,41529568,207.64784,Musical,6.2,99.0
83,"Sep 8, 2006",The Covenant,20000000,23364784,38164784,61529568,41529568,207.64784,Horror,5.2,90.0
84,"Jul 1, 2011",Monte Carlo,20000000,23186769,39686769,62873538,42873538,214.36769,"Adventure,Comedy,Family",5.8,109.0
87,"Jun 16, 2017",Rough Night,20000000,22105643,46844357,68950000,48950000,244.74999999999997,"Comedy,Crime,Thriller",5.2,101.0
88,"Dec 4, 1998",Psycho,20000000,21541218,37226218,58767436,38767436,193.83718000000002,Thriller,5.2,86.0
91,"Aug 21, 2009",Shorts,20000000,20919166,29870801,50789967,30789967,153.94983499999998,Drama,6.5,95.0
92,"Oct 30, 1998",Vampires,20000000,20268825,20268825,40537650,20537650,102.68825,"Comedy,Fantasy,Horror",6.2,88.0
94,"Nov 20, 2015",Secret in Their Eyes,20000000,20180155,32608019,52788174,32788174,163.94087,"Crime,Drama,Mystery",6.3,111.0
99,"Jul 31, 1981",Under the Rainbow,20000000,18826490,18826490,37652980,17652980,88.2649,"Comedy,Drama,Romance",5.9,112.0
99,"Jul 31, 1981",Under the Rainbow,20000000,18826490,18826490,37652980,17652980,88.2649,Horror,6.2,75.0
11,"Sep 29, 2017",Flatliners,20000000,16883115,45173738,62056853,42056853,210.284265,"Drama,Horror,Mystery",5.2,109.0
16,"Sep 3, 2004",Paparazzi,20000000,15712072,16612072,32324144,12324144,61.62072,"Action,Drama,Romance",5.9,110.0
22,"Apr 13, 2012",Lockout,20000000,14326865,33943049,48269914,28269914,141.34957,"Action,Sci-Fi,Thriller",6.1,95.0
24,"Sep 30, 2011",What's Your Number?,20000000,14011084,30163785,44174869,24174869,120.874345,"Comedy,Romance",6.1,106.0
27,"Oct 30, 2015",Burnt,20000000,13651946,36773510,50425456,30425456,152.12727999999998,"Comedy,Drama",6.6,101.0
33,"Feb 26, 2016",Triple 9,20000000,12639297,25943792,38583089,18583089,92.91544499999999,"Crime,Thriller",6.3,115.0
34,"Sep 2, 2016",The Light Between Oceans,20000000,12545979,22281732,34827711,14827711,74.138555,"Drama,Romance",7.2,133.0
38,"Oct 1, 2010",Let Me In,20000000,12134935,28270399,40405334,20405334,102.02667000000001,"Drama,Fantasy,Horror",7.1,116.0
38,"Oct 1, 2010",Let Me In,20000000,12134935,28270399,40405334,20405334,102.02667000000001,Horror,5.1,74.0
47,"Jun 3, 2016",Popstar: Never Stop Never Stopping,20000000,9496130,9537120,19033250,-966750,-4.83375,"Comedy,Music",6.7,87.0
48,"Oct 27, 2017",Thank You for Your Service,20000000,9479390,9985316,19464706,-535294,-2.6764699999999997,"Documentary,Drama",7.7,88.0
48,"Oct 27, 2017",Thank You for Your Service,20000000,9479390,9985316,19464706,-535294,-2.6764699999999997,"Biography,Drama,War",6.5,109.0
49,"Dec 4, 2009",Everybody's Fine,20000000,9208876,9208876,18417752,-1582248,-7.91124,Drama,5.9,105.0
51,"Sep 20, 2013",Battle of the Year,20000000,8888355,16723377,25611732,5611732,28.058660000000003,"Drama,Music",5.1,110.0
53,"Aug 17, 2007",Death at a Funeral,20000000,8580428,46790428,55370856,35370856,176.85428000000002,Comedy,5.7,92.0
54,"Sep 9, 2005",The Man,20000000,8330720,10393696,18724416,-1275584,-6.37792,Drama,6.3,94.0
56,"Dec 12, 2014",Inherent Vice,20000000,8110975,14772346,22883321,2883321,14.416604999999999,"Comedy,Crime,Drama",6.7,148.0
58,"Oct 11, 2013",Machete Kills,20000000,8008161,18273009,26281170,6281170,31.40585,"Action,Crime,Sci-Fi",5.6,107.0
65,"Apr 24, 2015",Little Boy,20000000,6485961,17769299,24255260,4255260,21.2763,"Drama,History,War",7.4,106.0
67,"Oct 26, 2012",Chasing Mavericks,20000000,6002756,8300821,14303577,-5696423,-28.482115000000004,"Biography,Drama,Sport",7.2,116.0
68,"Dec 31, 2014",A Most Violent Year,20000000,5749134,8846875,14596009,-5403991,-27.019955,"Crime,Drama,Thriller",7.0,125.0
69,"Nov 23, 2011",A Dangerous Method,20000000,5702083,14807531,20509614,509614,2.54807,"Biography,Drama,Romance",6.4,99.0
74,"Aug 26, 2016",Hands of Stone,20000000,4712792,5031975,9744767,-10255233,-51.276165,"Action,Biography,Drama",6.6,111.0
78,"Sep 7, 2012",The Cold Light of Day,20000000,3763583,25361206,29124789,9124789,45.623945,"Action,Thriller",4.9,93.0
81,"Oct 26, 2018",Suspiria,20000000,2483472,7034615,9518087,-10481913,-52.409565,"Fantasy,Horror,Mystery",6.8,152.0
82,"Nov 3, 2017",LBJ,20000000,2468683,2507181,4975864,-15024136,-75.12068,"Biography,Drama,History",6.5,98.0
85,"Nov 13, 2015",My All-American,20000000,2246000,2246000,4492000,-15508000,-77.53999999999999,"Biography,Drama,Sport",7.2,118.0
89,"Dec 6, 2002",Equilibrium,20000000,1190018,5345869,6535887,-13464113,-67.320565,"Comedy,Mystery,Thriller",5.7,77.0
89,"Dec 6, 2002",Equilibrium,20000000,1190018,5345869,6535887,-13464113,-67.320565,Drama,6.2,90.0
90,"Apr 29, 2011",Dylan Dog: Dead of Night,20000000,1186538,6093725,7280263,-12719737,-63.598684999999996,"Action,Comedy,Crime",5.1,107.0
94,"Aug 6, 2010",Middle Men,20000000,754301,754301,1508602,-18491398,-92.45698999999999,"Action,Comedy,Crime",5.8,82.0
96,"Dec 3, 2010",All Good Things,20000000,582024,873617,1455641,-18544359,-92.721795,"Crime,Drama,Mystery",6.3,101.0
97,"Nov 13, 2015",By the Sea,20000000,538460,3727746,4266206,-15733794,-78.66897,"Drama,Romance",5.3,122.0
97,"Nov 13, 2015",By the Sea,20000000,538460,3727746,4266206,-15733794,-78.66897,Drama,8.0,80.0
1,"Dec 10, 2010",The Tempest,20000000,277943,277943,555886,-19444114,-97.22057,"Comedy,Drama,Fantasy",5.4,110.0
1,"Dec 10, 2010",The Tempest,20000000,277943,277943,555886,-19444114,-97.22057,Drama,7.8,131.0
1,"Dec 10, 2010",The Tempest,20000000,277943,277943,555886,-19444114,-97.22057,"Comedy,Drama",8.5,169.0
6,"Oct 30, 2015",Regression,20000000,55039,15824374,15879413,-4120587,-20.602935,"Crime,Horror,Mystery",5.7,106.0
7,"Dec 31, 2008",Admiral,20000000,0,38585047,38585047,18585047,92.925235,"Action,Adventure,Biography",7.0,151.0
8,"Dec 31, 2012",Zambezia,20000000,0,34454336,34454336,14454336,72.27168,"Adventure,Animation,Comedy",5.8,83.0
11,"May 29, 2015",Survivor,20000000,0,1703281,1703281,-18296719,-91.483595,"Biography,Crime,Documentary",9.0,81.0
11,"May 29, 2015",Survivor,20000000,0,1703281,1703281,-18296719,-91.483595,"Action,Crime,Thriller",5.6,96.0
11,"May 29, 2015",Survivor,20000000,0,1703281,1703281,-18296719,-91.483595,"Action,Adventure,Fantasy",4.1,93.0
12,"Nov 18, 2016",The History of Love,20000000,0,476624,476624,-19523376,-97.61688,"Drama,Romance,War",6.3,134.0
14,"Aug 29, 2014",Dwegons and Leprechauns,20000000,0,0,0,-20000000,-100.0,Animation,4.2,98.0
15,"Jul 22, 2016",Fight Valley,20000000,0,0,0,-20000000,-100.0,"Action,Drama",2.7,90.0
17,"Dec 13, 2018",Bird Box,19800000,0,0,0,-19800000,-100.0,"Drama,Horror,Sci-Fi",6.6,124.0
19,"Dec 1, 2017",The Shape of Water,19500000,63859435,195790794,259650229,240150229,1231.539635897436,"Adventure,Drama,Fantasy",7.3,123.0
22,"Aug 23, 2013",The Frozen Ground,19200000,0,5617460,5617460,-13582540,-70.74239583333333,"Crime,Drama,Mystery",6.4,105.0
23,"Jul 29, 2011",The Devil's Double,19100000,1361512,5965646,7327158,-11772842,-61.6379162303665,"Biography,Drama,Thriller",7.1,109.0
27,"Jun 24, 2011",Bad Teacher,19000000,100292856,215448997,315741853,296741853,1561.7992263157894,"Comedy,Romance",5.7,92.0
28,"Aug 12, 2016",Sausage Party,19000000,97670358,141344255,239014613,220014613,1157.9716473684211,"Adventure,Animation,Comedy",6.2,89.0
36,"Feb 26, 2010",The Crazies,19000000,39123589,56445534,95569123,76569123,402.99538421052625,"Horror,Thriller",6.5,101.0
39,"Aug 20, 2010",The Switch,19000000,27758465,49858465,77616930,58616930,308.51015789473684,"Comedy,Drama,Romance",6.1,101.0
40,"Jan 8, 2010",Leap Year,19000000,25918920,32618920,58537840,39537840,208.09389473684212,"Comedy,Romance",6.5,100.0
40,"Jan 8, 2010",Leap Year,19000000,25918920,32618920,58537840,39537840,208.09389473684212,"Drama,Romance",5.9,94.0
41,"Nov 8, 2013",The Book Thief,19000000,21488481,76086711,97575192,78575192,413.5536421052632,"Drama,War",7.6,131.0
47,"Jan 9, 1998",Firestorm,19000000,8123860,8123860,16247720,-2752280,-14.485684210526314,Documentary,7.3,54.0
47,"Jan 9, 1998",Firestorm,19000000,8123860,8123860,16247720,-2752280,-14.485684210526314,"Action,Crime,Thriller",6.2,118.0
48,"Mar 4, 2011",Take Me Home Tonight,19000000,6928068,7576604,14504672,-4495328,-23.65962105263158,"Comedy,Drama,Romance",6.3,97.0
49,"Sep 28, 2012",Won't Back Down,19000000,5310554,5745503,11056057,-7943943,-41.81022631578947,Drama,6.4,121.0
49,"Sep 28, 2012",Won't Back Down,19000000,5310554,5745503,11056057,-7943943,-41.81022631578947,Sport,7.9,114.0
50,"Jun 1, 2018",Action Point,19000000,5059608,5103675,10163283,-8836717,-46.50903684210526,Comedy,5.0,85.0
63,"Feb 2, 2001",Left Behind,18500000,4221341,4221341,8442682,-10057318,-54.363881081081075,"Horror,Mystery,Thriller",6.5,86.0
63,"Feb 2, 2001",Left Behind,18500000,4221341,4221341,8442682,-10057318,-54.363881081081075,"Action,Drama,Fantasy",3.1,110.0
64,"May 9, 2014",Neighbors,18000000,150086800,270944428,421031228,403031228,2239.062377777778,Comedy,6.3,97.0
64,"May 9, 2014",Neighbors,18000000,150086800,270944428,421031228,403031228,2239.062377777778,"Comedy,Drama",7.6,90.0
66,"Jul 29, 1994",The Mask,18000000,119920129,351620129,471540258,453540258,2519.6681000000003,"Crime,Fantasy,Thriller",5.7,139.0
67,"Jun 3, 1988",Big,18000000,114968774,151668774,266637548,248637548,1381.319711111111,Documentary,8.5,99.0
77,"Mar 25, 2016",My Big Fat Greek Wedding 2,18000000,59689605,92096558,151786163,133786163,743.2564611111111,"Comedy,Romance",6.0,94.0
78,"Sep 11, 2015",The Perfect Guy,18000000,57027435,60278166,117305601,99305601,551.6977833333334,"Crime,Drama,Horror",5.6,100.0
80,"Mar 25, 2011",Diary of a Wimpy Kid: Rodrick Rules,18000000,52698535,73695194,126393729,108393729,602.1873833333333,"Comedy,Family",6.6,99.0
83,"Apr 8, 2011",Soul Surfer,18000000,43853424,47158652,91012076,73012076,405.62264444444446,"Biography,Drama,Family",7.1,112.0
85,"Jun 29, 2018",Uncle Drew,18000000,42469946,46527161,88997107,70997107,394.4283722222222,"Comedy,Sport",5.7,103.0
86,"Oct 17, 2014",Birdman or (The Unexpected Virtue of Ignorance),18000000,42340598,103215094,145555692,127555692,708.6427333333334,"Comedy,Drama",7.7,119.0
90,"Jul 26, 2013",Blue Jasmine,18000000,33404871,102912961,136317832,118317832,657.3212888888888,Drama,7.3,98.0
92,"Dec 5, 2003",Honey,18000000,30272254,62646763,92919017,74919017,416.2167611111111,Drama,7.2,103.0
92,"Dec 5, 2003",Honey,18000000,30272254,62646763,92919017,74919017,416.2167611111111,Drama,6.8,96.0
92,"Dec 5, 2003",Honey,18000000,30272254,62646763,92919017,74919017,416.2167611111111,"Drama,Romance",7.3,105.0
95,"Aug 7, 2015",Ricki and the Flash,18000000,26839498,41166033,68005531,50005531,277.80850555555554,"Comedy,Drama,Music",5.9,101.0
96,"Dec 13, 1989",Glory,18000000,26593580,26593580,53187160,35187160,195.48422222222223,Drama,7.6,101.0
98,"Nov 13, 2015",Love the Coopers,18000000,26302731,42227490,68530221,50530221,280.72344999999996,"Comedy,Fantasy,Romance",5.8,107.0
3,"Sep 25, 2009",Fame,18000000,22455510,80227619,102683129,84683129,470.4618277777778,Documentary,8.6,58.0
4,"Apr 28, 2017",The Circle,18000000,20497844,40651864,61149708,43149708,239.72060000000002,"Drama,Fantasy,Horror",5.9,144.0
4,"Apr 28, 2017",The Circle,18000000,20497844,40651864,61149708,43149708,239.72060000000002,"Adventure,Documentary,History",7.6,48.0
4,"Apr 28, 2017",The Circle,18000000,20497844,40651864,61149708,43149708,239.72060000000002,"Drama,Horror,Thriller",5.1,93.0
4,"Apr 28, 2017",The Circle,18000000,20497844,40651864,61149708,43149708,239.72060000000002,"Biography,Drama,Romance",7.3,102.0
4,"Apr 28, 2017",The Circle,18000000,20497844,40651864,61149708,43149708,239.72060000000002,"Drama,Sci-Fi,Thriller",5.3,110.0
6,"Nov 5, 2010",127 Hours,18000000,18335230,60217171,78552401,60552401,336.4022277777778,"Adventure,Biography,Drama",7.6,94.0
9,"Jan 15, 2016",Norm of the North,18000000,17062499,30535660,47598159,29598159,164.43421666666666,"Adventure,Animation,Comedy",3.6,90.0
11,"Aug 16, 2013",Jobs,18000000,16131410,43402515,59533925,41533925,230.74402777777777,"Biography,Drama",5.9,128.0
14,"Jul 25, 2014",And So It Goes,18000000,15160801,17920013,33080814,15080814,83.78229999999999,"Comedy,Drama,Romance",5.8,94.0
19,"Jan 31, 2014",Labor Day,18000000,13371528,14189810,27561338,9561338,53.118544444444446,"Drama,Romance",6.9,111.0
20,"Aug 30, 2013",Getaway,18000000,10501938,11813989,22315927,4315927,23.977372222222222,"Action,Crime,Thriller",4.4,90.0
25,"Jan 15, 2010",The Last Station,18000000,6617867,15696146,22314013,4314013,23.966738888888887,Documentary,7.6,90.0
26,"Jun 26, 1981",Dragonslayer,18000000,6000000,6000000,12000000,-6000000,-33.33333333333333,Documentary,5.8,74.0
32,"Dec 25, 1996",Hamlet,18000000,4501094,7129670,11630764,-6369236,-35.38464444444445,Drama,5.4,88.0
32,"Dec 25, 1996",Hamlet,18000000,4501094,7129670,11630764,-6369236,-35.38464444444445,Drama,5.6,90.0
32,"Dec 25, 1996",Hamlet,18000000,4501094,7129670,11630764,-6369236,-35.38464444444445,Drama,6.5,184.0
32,"Dec 25, 1996",Hamlet,18000000,4501094,7129670,11630764,-6369236,-35.38464444444445,Drama,8.6,217.0
32,"Dec 25, 1996",Hamlet,18000000,4501094,7129670,11630764,-6369236,-35.38464444444445,Drama,7.6,166.0
33,"Apr 11, 2014",The Railway Man,18000000,4438438,23910210,28348648,10348648,57.49248888888889,"Biography,Drama,Romance",7.1,116.0
34,"Dec 29, 1995",Restoration,18000000,4100000,4100000,8200000,-9800000,-54.44444444444444,Drama,6.8,102.0
34,"Dec 29, 1995",Restoration,18000000,4100000,4100000,8200000,-9800000,-54.44444444444444,"Sci-Fi,Thriller",6.7,50.0
34,"Dec 29, 1995",Restoration,18000000,4100000,4100000,8200000,-9800000,-54.44444444444444,Horror,4.0,92.0
34,"Dec 29, 1995",Restoration,18000000,4100000,4100000,8200000,-9800000,-54.44444444444444,Drama,8.4,93.0
35,"Mar 18, 2016",Midnight Special,18000000,3712282,7680250,11392532,-6607468,-36.70815555555556,"Action,Drama,Mystery",6.6,112.0
36,"Nov 25, 2016",Miss Sloane,18000000,3500605,7719630,11220235,-6779765,-37.66536111111111,"Drama,Thriller",7.5,132.0
37,"Sep 27, 2013",Metallica Through the Never,18000000,3419967,9082906,12502873,-5497127,-30.539594444444447,Music,7.2,93.0
39,"Feb 23, 1996",Unforgettable,18000000,2483790,2483790,4967580,-13032420,-72.40233333333333,Documentary,5.9,88.0
39,"Feb 23, 1996",Unforgettable,18000000,2483790,2483790,4967580,-13032420,-72.40233333333333,"Drama,Romance",5.5,130.0
39,"Feb 23, 1996",Unforgettable,18000000,2483790,2483790,4967580,-13032420,-72.40233333333333,"Drama,Thriller",5.1,100.0
39,"Feb 23, 1996",Unforgettable,18000000,2483790,2483790,4967580,-13032420,-72.40233333333333,"Drama,Romance",7.3,113.0
43,"Mar 1, 2013",Phantom,18000000,1034589,1199510,2234099,-15765901,-87.58833888888888,"Drama,History,Thriller",5.9,98.0
43,"Mar 1, 2013",Phantom,18000000,1034589,1199510,2234099,-15765901,-87.58833888888888,Drama,7.7,76.0
43,"Mar 1, 2013",Phantom,18000000,1034589,1199510,2234099,-15765901,-87.58833888888888,"Action,Drama,Thriller",5.8,136.0
43,"Mar 1, 2013",Phantom,18000000,1034589,1199510,2234099,-15765901,-87.58833888888888,"Crime,Horror,Thriller",8.2,106.0
44,"Apr 26, 2002",The Salton Sea,18000000,676698,676698,1353396,-16646604,-92.48113333333333,"Crime,Drama,Mystery",6.5,87.0
50,"Apr 15, 2016",I Am Wrath,18000000,0,309608,309608,-17690392,-98.27995555555556,"Action,Crime,Drama",5.4,92.0
51,"Nov 14, 2014",Wolves,18000000,0,94953,94953,-17905047,-99.47248333333333,"Action,Fantasy,Horror",5.3,91.0
51,"Nov 14, 2014",Wolves,18000000,0,94953,94953,-17905047,-99.47248333333333,"Drama,Sport",5.6,109.0
53,"Aug 22, 2014",The Prince,18000000,0,0,0,-18000000,-100.0,"Action,Thriller",4.6,93.0
54,"Feb 19, 2016",Forsaken,18000000,0,0,0,-18000000,-100.0,"Action,Drama,Western",6.3,90.0
54,"Feb 19, 2016",Forsaken,18000000,0,0,0,-18000000,-100.0,"Adventure,Drama,Sci-Fi",3.1,95.0
54,"Feb 19, 2016",Forsaken,18000000,0,0,0,-18000000,-100.0,Drama,4.6,80.0
54,"Feb 19, 2016",Forsaken,18000000,0,0,0,-18000000,-100.0,Horror,2.1,89.0
54,"Feb 19, 2016",Forsaken,18000000,0,0,0,-18000000,-100.0,Thriller,5.0,86.0
56,"Jul 13, 2012",Red Lights,17700000,49521,14518884,14568405,-3131595,-17.692627118644065,"Drama,Fantasy,Horror",6.2,114.0
63,"Nov 27, 2013",Black Nativity,17500000,7018188,7285135,14303323,-3196677,-18.266725714285712,"Drama,Family,Music",4.6,93.0
64,"Apr 25, 2003",City of Ghosts,17500000,325491,325491,650982,-16849018,-96.28010285714285,"Documentary,War",7.4,92.0
66,"Apr 6, 2018",A Quiet Place,17000000,188024361,334522294,522546655,505546655,2973.8038529411765,Documentary,6.6,80.0
66,"Apr 6, 2018",A Quiet Place,17000000,188024361,334522294,522546655,505546655,2973.8038529411765,"Drama,Horror,Sci-Fi",7.6,90.0
68,"Jul 18, 1986",Aliens,17000000,85160248,183316455,268476703,251476703,1479.2747235294116,"Comedy,Mystery,Sci-Fi",2.7,88.0
73,"Nov 15, 2013",The Best Man Holiday,17000000,70525195,72835710,143360905,126360905,743.2994411764706,"Comedy,Drama",6.7,123.0
75,"Sep 28, 2012",Pitch Perfect,17000000,65001093,116044347,181045440,164045440,964.9731764705882,"Comedy,Music,Romance",7.2,112.0
77,"Apr 5, 2013",Evil Dead,17000000,54239856,97778356,152018212,135018212,794.2247764705883,"Fantasy,Horror,Thriller",6.5,91.0
80,"Feb 20, 2015","McFarland, USA",17000000,44480275,45707924,90188199,73188199,430.5188176470589,"Biography,Drama,Sport",7.4,129.0
81,"Nov 11, 2016",Almost Christmas,17000000,42065185,42493506,84558691,67558691,397.4040647058823,"Comedy,Drama",6.1,111.0
87,"Mar 4, 2011",Beastly,17000000,27865571,38028230,65893801,48893801,287.61059411764705,"Drama,Fantasy,Romance",5.6,86.0
90,"Aug 20, 2010",Lottery Ticket,17000000,24719879,24719879,49439758,32439758,190.82210588235293,Comedy,5.0,99.0
4,"Aug 24, 2012",The Apparition,17000000,4936819,10637281,15574100,-1425900,-8.387647058823529,"Horror,Thriller",4.1,83.0
4,"Aug 24, 2012",The Apparition,17000000,4936819,10637281,15574100,-1425900,-8.387647058823529,Drama,6.4,144.0
10,"Jun 10, 2016",Genius,17000000,1361045,7265283,8626328,-8373672,-49.25689411764706,"Biography,Drama",6.6,104.0
10,"Jun 10, 2016",Genius,17000000,1361045,7265283,8626328,-8373672,-49.25689411764706,"Action,Thriller",4.7,165.0
12,"Jun 26, 2015",Escobar: Paradise Lost,17000000,195792,3917679,4113471,-12886529,-75.80311176470587,"Crime,Drama,History",6.5,120.0
16,"Jul 12, 2019",Crawl,17000000,0,0,0,-17000000,-100.0,"Crime,Thriller",4.7,80.0
16,"Jul 12, 2019",Crawl,17000000,0,0,0,-17000000,-100.0,Drama,6.0,95.0
17,"Mar 11, 2016",The Young Messiah,16800000,6469813,7313697,13783510,-3016490,-17.95529761904762,"Drama,Fantasy",5.6,111.0
22,"Aug 18, 2006",The Illusionist,16500000,39868642,83792062,123660704,107160704,649.4588121212122,"Animation,Drama",7.5,80.0
30,"May 19, 2000",Road Trip,16000000,68525609,119739110,188264719,172264719,1076.65449375,Horror,6.5,90.0
33,"May 25, 2012",Moonrise Kingdom,16000000,45512466,68848446,114360912,98360912,614.7557,"Adventure,Comedy,Drama",7.8,94.0
34,"Nov 25, 2011",The Artist,16000000,44667095,128256712,172923807,156923807,980.7737937500001,"Comedy,Drama,Romance",7.9,100.0
34,"Nov 25, 2011",The Artist,16000000,44667095,128256712,172923807,156923807,980.7737937500001,Thriller,6.8,100.0
39,"Feb 4, 2011",The Roommate,16000000,37300107,52545707,89845814,73845814,461.5363375,"Drama,Thriller",4.9,91.0
51,"Mar 12, 2010",Remember Me,16000000,19068240,56506120,75574360,59574360,372.33975,"Drama,Romance",7.1,113.0
51,"Mar 12, 2010",Remember Me,16000000,19068240,56506120,75574360,59574360,372.33975,Comedy,5.2,85.0
57,"Oct 3, 2014",Left Behind,16000000,14019924,20769209,34789133,18789133,117.43208125,"Horror,Mystery,Thriller",6.5,86.0
57,"Oct 3, 2014",Left Behind,16000000,14019924,20769209,34789133,18789133,117.43208125,"Action,Drama,Fantasy",3.1,110.0
60,"Jun 29, 2012",People Like Us,16000000,12431792,12617472,25049264,9049264,56.557900000000004,"Comedy,Drama",7.1,114.0
60,"Jun 29, 2012",People Like Us,16000000,12431792,12617472,25049264,9049264,56.557900000000004,Drama,6.4,55.0
65,"Nov 18, 2016",Bleed for This,16000000,5083906,6603926,11687832,-4312168,-26.95105,"Biography,Drama,Sport",6.8,117.0
70,"Nov 14, 2014",The Homesman,16000000,2429989,8217571,10647560,-5352440,-33.452749999999995,"Drama,Western",6.6,122.0
71,"Apr 5, 2013",Trance,16000000,2322593,22594052,24916645,8916645,55.729031250000006,Horror,4.6,83.0
71,"Apr 5, 2013",Trance,16000000,2322593,22594052,24916645,8916645,55.729031250000006,"Crime,Drama,Mystery",6.9,101.0
72,"May 16, 2014",The Immigrant,16000000,2013456,7585011,9598467,-6401533,-40.00958125,"Drama,Romance",6.6,120.0
73,"Aug 15, 1997",Steel,16000000,1686429,1686429,3372858,-12627142,-78.9196375,Drama,5.7,95.0
73,"Aug 15, 1997",Steel,16000000,1686429,1686429,3372858,-12627142,-78.9196375,"Drama,Mystery,Romance",5.5,108.0
79,"Nov 2, 2012",Vamps,16000000,3361,94812,98173,-15901827,-99.38641875,"Comedy,Horror,Romance",5.2,92.0
79,"Nov 2, 2012",Vamps,16000000,3361,94812,98173,-15901827,-99.38641875,"Comedy,Horror,Thriller",4.5,89.0
82,"Dec 31, 2013",Zulu,16000000,0,1844228,1844228,-14155772,-88.47357500000001,"Crime,Drama,Thriller",6.7,110.0
83,"Dec 21, 2018",Second Act,15700000,39282227,63288854,102571081,86871081,553.3189872611465,"Comedy,Drama,Romance",5.8,103.0
2,"Aug 11, 2017",Annabelle: Creation,15000000,102092201,305384865,407477066,392477066,2616.5137733333336,"Horror,Mystery,Thriller",6.5,109.0
5,"Dec 18, 1985",The Color Purple,15000000,93589701,93589701,187179402,172179402,1147.8626800000002,"Action,Drama",6.6,97.0
6,"Nov 28, 2014",The Imitation Game,15000000,91125143,227740463,318865606,303865606,2025.7707066666665,"Biography,Drama,Thriller",8.0,114.0
8,"Nov 18, 1959",Ben-Hur,15000000,73000000,73259017,146259017,131259017,875.0601133333333,"Action,Adventure,Drama",5.7,123.0
9,"Jan 18, 2013",Mama,15000000,71628180,148095566,219723746,204723746,1364.8249733333334,Drama,4.5,50.0
9,"Jan 18, 2013",Mama,15000000,71628180,148095566,219723746,204723746,1364.8249733333334,Drama,6.8,71.0
9,"Jan 18, 2013",Mama,15000000,71628180,148095566,219723746,204723746,1364.8249733333334,"Horror,Thriller",6.2,100.0
9,"Jan 18, 2013",Mama,15000000,71628180,148095566,219723746,204723746,1364.8249733333334,Drama,6.6,110.0
9,"Jan 18, 2013",Mama,15000000,71628180,148095566,219723746,204723746,1364.8249733333334,Drama,6.7,90.0
13,"Mar 19, 2010",Diary of a Wimpy Kid,15000000,64003625,76954311,140957936,125957936,839.7195733333333,"Comedy,Drama,Family",6.2,94.0
15,"Aug 31, 2007",Halloween,15000000,58269151,77514401,135783552,120783552,805.22368,"Horror,Thriller",6.6,106.0
16,"Sep 30, 2006",The Queen,15000000,56441711,128885873,185327584,170327584,1135.5172266666666,"Action,Drama,War",6.7,104.0
18,"Feb 3, 2012",The Woman in Black,15000000,54333290,128955898,183289188,168289188,1121.92792,"Drama,Fantasy,Horror",6.4,95.0
19,"Dec 21, 1994",Little Women,15000000,50003303,50003303,100006606,85006606,566.7107066666666,"Drama,Family",4.6,112.0
21,"Aug 10, 2018",BlacKkKlansman,15000000,49275340,93017335,142292675,127292675,848.6178333333334,"Biography,Crime,Drama",7.5,135.0
26,"Feb 22, 2013",Snitch,15000000,42930462,57907734,100838196,85838196,572.25464,"Action,Drama,Thriller",6.5,112.0
28,"Dec 4, 2015",Krampus,15000000,42725475,61788393,104513868,89513868,596.75912,"Comedy,Fantasy,Horror",6.2,98.0
29,"Sep 21, 2012",End of Watch,15000000,41003371,57586606,98589977,83589977,557.2665133333334,"Action,Crime,Drama",7.6,109.0
33,"Dec 3, 2014",Wild,15000000,37880356,52460543,90340899,75340899,502.27266000000003,"Adventure,Biography,Drama",7.1,115.0
33,"Dec 3, 2014",Wild,15000000,37880356,52460543,90340899,75340899,502.27266000000003,Drama,6.5,97.0
33,"Dec 3, 2014",Wild,15000000,37880356,52460543,90340899,75340899,502.27266000000003,Documentary,6.8,80.0
33,"Dec 3, 2014",Wild,15000000,37880356,52460543,90340899,75340899,502.27266000000003,"Drama,Romance",4.9,92.0
35,"Nov 7, 2014",The Theory of Everything,15000000,35893537,123327692,159221229,144221229,961.47486,"Biography,Drama,Romance",7.7,123.0
36,"Sep 16, 2011",Drive,15000000,35060689,81357930,116418619,101418619,676.1241266666667,"Crime,Drama",7.8,100.0
36,"Sep 16, 2011",Drive,15000000,35060689,81357930,116418619,101418619,676.1241266666667,Documentary,6.3,55.0
38,"Oct 10, 1966",Hawaii,15000000,34562222,34562222,69124444,54124444,360.8296266666667,"Drama,Romance",7.3,102.0
38,"Oct 10, 1966",Hawaii,15000000,34562222,34562222,69124444,54124444,360.8296266666667,Drama,7.7,116.0
39,"Nov 23, 2018",The Favourite,15000000,34366783,94113929,128480712,113480712,756.53808,"Biography,Drama,History",7.6,119.0
50,"Aug 22, 2014",When the Game Stands Tall,15000000,30127963,30138912,60266875,45266875,301.77916666666664,"Drama,Family,Sport",6.7,115.0
51,"Jun 12, 1981",Clash of the Titans,15000000,30000000,44400000,74400000,59400000,396.0,"Action,Adventure,Fantasy",5.8,106.0
57,"Sep 8, 2017",Home Again,15000000,27020284,37336874,64357158,49357158,329.04772,Drama,6.6,104.0
57,"Sep 8, 2017",Home Again,15000000,27020284,37336874,64357158,49357158,329.04772,"Comedy,Drama,Romance",5.8,97.0
60,"Jul 23, 2010",Ramona and Beezus,15000000,26167002,27469621,53636623,38636623,257.5774866666667,"Adventure,Comedy,Family",6.6,103.0
61,"Aug 27, 2014",The November Man,15000000,25018119,34820335,59838454,44838454,298.92302666666666,"Action,Crime,Thriller",6.3,108.0
67,"Mar 29, 2013",The Place Beyond the Pines,15000000,21403519,47011449,68414968,53414968,356.09978666666666,"Crime,Drama,Thriller",7.3,140.0
70,"Apr 29, 2016",Keanu,15000000,20591853,20688141,41279994,26279994,175.19996,"Action,Comedy,Crime",6.3,100.0
71,"Dec 22, 2010",Country Strong,15000000,20218921,20601987,40820908,25820908,172.13938666666667,"Drama,Music",6.3,117.0
76,"Jul 25, 2014",A Most Wanted Man,15000000,17237855,36068890,53306745,38306745,255.37830000000002,"Crime,Drama,Thriller",6.8,122.0
79,"Nov 2, 2012",The Man with the Iron Fists,15000000,15634090,22018988,37653078,22653078,151.02052,Action,5.4,95.0
81,"Feb 1, 2019",Miss Bala,15000000,14998027,15362298,30360325,15360325,102.40216666666666,"Crime,Drama,Thriller",6.5,113.0
81,"Feb 1, 2019",Miss Bala,15000000,14998027,15362298,30360325,15360325,102.40216666666666,"Action,Crime,Drama",5.5,104.0
82,"Nov 30, 2012",Killing Them Softly,15000000,14945541,39238443,54183984,39183984,261.22656,"Crime,Thriller",6.2,97.0
84,"Aug 19, 2011",One Day,15000000,13843771,59168692,73012463,58012463,386.74975333333333,"Drama,Romance",7.0,107.0
84,"Aug 19, 2011",One Day,15000000,13843771,59168692,73012463,58012463,386.74975333333333,"Drama,Romance,Sci-Fi",6.0,93.0
84,"Aug 19, 2011",One Day,15000000,13843771,59168692,73012463,58012463,386.74975333333333,Family,6.2,90.0
84,"Aug 19, 2011",One Day,15000000,13843771,59168692,73012463,58012463,386.74975333333333,"Drama,Romance",7.8,135.0
84,"Aug 19, 2011",One Day,15000000,13843771,59168692,73012463,58012463,386.74975333333333,"Drama,Fantasy",6.6,118.0
84,"Aug 19, 2011",One Day,15000000,13843771,59168692,73012463,58012463,386.74975333333333,Drama,7.2,99.0
90,"Jan 20, 2017",The Founder,15000000,12786053,24403192,37189245,22189245,147.92829999999998,"Comedy,Sci-Fi",5.9,108.0
90,"Jan 20, 2017",The Founder,15000000,12786053,24403192,37189245,22189245,147.92829999999998,"Biography,Drama,History",7.2,115.0
94,"Aug 27, 1999",The Muse,15000000,11614954,11614954,23229908,8229908,54.86605333333333,"Horror,Mystery,Thriller",6.1,58.0
94,"Aug 27, 1999",The Muse,15000000,11614954,11614954,23229908,8229908,54.86605333333333,"Horror,Music,Thriller",5.8,90.0
3,"Feb 21, 2003",Dark Blue,15000000,9237470,12262065,21499535,6499535,43.33023333333333,"Crime,Drama",8.9,85.0
6,"Sep 23, 2016",Queen of Katwe,15000000,8874389,10055481,18929870,3929870,26.199133333333336,"Biography,Drama,Sport",7.4,124.0
13,"Jan 4, 2013",Promised Land,15000000,7597898,12394562,19992460,4992460,33.28306666666666,Drama,6.6,106.0
15,"Jun 8, 2018",Hotel Artemis,15000000,6708137,12758799,19466936,4466936,29.77957333333333,"Action,Drama,Sci-Fi",6.1,94.0
25,"Oct 30, 2015",Scouts Guide to the Zombie Apocalypse,15000000,3703046,15554855,19257901,4257901,28.38600666666667,"Action,Comedy,Horror",6.3,93.0
27,"Sep 22, 2010",You Will Meet a Tall Dark Stranger,15000000,3247816,34247816,37495632,22495632,149.97088,"Comedy,Drama,Romance",6.3,98.0
28,"Oct 23, 2015",Rock the Kasbah,15000000,3020665,3386153,6406818,-8593182,-57.28788,"Comedy,Music,War",5.5,106.0
29,"Sep 15, 2010",Never Let Me Go,15000000,2434652,11173718,13608370,-1391630,-9.277533333333334,"Drama,Romance,Sci-Fi",7.1,103.0
30,"Sep 9, 2016",The Disappointments Room,15000000,2423467,3503761,5927228,-9072772,-60.485146666666665,"Drama,Horror,Thriller",3.9,85.0
35,"Feb 3, 2017",The Comedian,15000000,1658706,1658706,3317412,-11682588,-77.88391999999999,"Drama,Romance",5.5,79.0
35,"Feb 3, 2017",The Comedian,15000000,1658706,1658706,3317412,-11682588,-77.88391999999999,Comedy,5.7,120.0
42,"Apr 26, 2013",The Reluctant Fundamentalist,15000000,528731,528731,1057462,-13942538,-92.95025333333334,"Drama,Thriller",6.9,130.0
43,"Feb 6, 2004",The Return,15000000,501752,5953886,6455638,-8544362,-56.96241333333333,Drama,7.2,102.0
43,"Feb 6, 2004",The Return,15000000,501752,5953886,6455638,-8544362,-56.96241333333333,Drama,6.0,69.0
43,"Feb 6, 2004",The Return,15000000,501752,5953886,6455638,-8544362,-56.96241333333333,"Crime,Mystery,Thriller",6.3,92.0
43,"Feb 6, 2004",The Return,15000000,501752,5953886,6455638,-8544362,-56.96241333333333,"Horror,Mystery,Thriller",5.4,55.0
43,"Feb 6, 2004",The Return,15000000,501752,5953886,6455638,-8544362,-56.96241333333333,Adventure,8.2,100.0
43,"Feb 6, 2004",The Return,15000000,501752,5953886,6455638,-8544362,-56.96241333333333,Drama,4.8,80.0
43,"Feb 6, 2004",The Return,15000000,501752,5953886,6455638,-8544362,-56.96241333333333,Documentary,6.6,84.0
43,"Feb 6, 2004",The Return,15000000,501752,5953886,6455638,-8544362,-56.96241333333333,"Documentary,Drama",7.1,85.0
43,"Feb 6, 2004",The Return,15000000,501752,5953886,6455638,-8544362,-56.96241333333333,"Action,Crime,Drama",7.3,105.0
43,"Feb 6, 2004",The Return,15000000,501752,5953886,6455638,-8544362,-56.96241333333333,"Action,Documentary",6.9,78.0
46,"Aug 27, 2010",Centurion,15000000,123570,7885048,8008618,-6991382,-46.60921333333333,"Action,Adventure,Drama",6.4,97.0
50,"Sep 6, 2013",Winnie Mandela,15000000,61847,61847,123694,-14876306,-99.17537333333334,"Biography,Drama,History",6.0,104.0
51,"Nov 4, 2011",The Son of No One,15000000,30680,1148578,1179258,-13820742,-92.13828,"Action,Crime,Drama",5.1,90.0
54,"Dec 6, 2013",Khumba,15000000,0,20898221,20898221,5898221,39.32147333333334,"Adventure,Animation,Family",5.7,85.0
55,"May 5, 2015",A Few Best Men,15000000,0,17224539,17224539,2224539,14.83026,"Comedy,Romance",5.7,97.0
58,"Dec 31, 2008",Bathory,15000000,0,3436763,3436763,-11563237,-77.08824666666668,Drama,5.8,88.0
61,"Feb 17, 2017",In Dubious Battle,15000000,0,214182,214182,-14785818,-98.57212,Drama,6.1,110.0
62,"Sep 1, 2015",Broken Horses,15000000,0,3471,3471,-14996529,-99.97686,"Action,Crime,Drama",5.7,101.0
64,"Aug 14, 2019",Blinded by the Light,15000000,0,0,0,-15000000,-100.0,"Biography,Comedy,Drama",6.2,117.0
66,"Jul 1, 2015",Magic Mike XXL,14500000,66013057,123660597,189673654,175173654,1208.0941655172414,"Comedy,Drama,Music",5.6,115.0
69,"Jun 5, 2015",Freedom,14500000,0,872757,872757,-13627243,-93.98098620689656,Documentary,7.0,88.0
69,"Jun 5, 2015",Freedom,14500000,0,872757,872757,-13627243,-93.98098620689656,"Drama,Music",6.2,94.0
69,"Jun 5, 2015",Freedom,14500000,0,872757,872757,-13627243,-93.98098620689656,Drama,6.0,100.0
70,"Aug 7, 1992",Unforgiven,14400000,101157447,159157447,260314894,245914894,1707.7423194444445,"Action,Crime,Drama",7.2,135.0
70,"Aug 7, 1992",Unforgiven,14400000,101157447,159157447,260314894,245914894,1707.7423194444445,Drama,6.3,106.0
81,"Aug 31, 2012",The Possession,14000000,49130588,82925064,132055652,118055652,843.254657142857,"Horror,Mystery,Thriller",5.9,92.0
87,"Jan 18, 1991",White Fang,14000000,34729091,34729091,69458182,55458182,396.12987142857145,"Adventure,Animation",7.0,85.0
88,"Dec 21, 1988",Dangerous Liaisons,14000000,34700000,34700000,69400000,55400000,395.7142857142857,"Drama,Mystery,Romance",5.9,110.0
89,"Oct 8, 1999",Superstar,14000000,30628981,30628981,61257962,47257962,337.55687142857147,Drama,5.3,112.0
90,"Jan 13, 2012",The Iron Lady,14000000,29959436,115592104,145551540,131551540,939.6538571428572,"Biography,Drama",6.4,105.0
95,"Mar 12, 2010",Our Family Wedding,14000000,20255281,21410546,41665827,27665827,197.61305,"Comedy,Romance",4.9,103.0
7,"Feb 20, 2015",Hot Tub Time Machine 2,14000000,12314651,12826644,25141295,11141295,79.58067857142858,"Comedy,Mystery,Sci-Fi",5.1,93.0
8,"Nov 17, 2006",Bobby,14000000,11242801,20597806,31840607,17840607,127.43290714285713,"Biography,Documentary,Sport",7.1,97.0
8,"Nov 17, 2006",Bobby,14000000,11242801,20597806,31840607,17840607,127.43290714285713,"Comedy,Romance",6.8,142.0
8,"Nov 17, 2006",Bobby,14000000,11242801,20597806,31840607,17840607,127.43290714285713,Drama,8.9,130.0
9,"Feb 2, 2001",Head Over Heels,14000000,10397365,10397365,20794730,6794730,48.53378571428571,Comedy,5.7,101.0
10,"Oct 26, 2012",Fun Size,14000000,9409538,11166615,20576153,6576153,46.972521428571426,"Adventure,Comedy",5.4,86.0
11,"Apr 23, 1999",Lost and Found,14000000,6552255,6552255,13104510,-895490,-6.396357142857142,"Animation,Drama",5.0,111.0
11,"Apr 23, 1999",Lost and Found,14000000,6552255,6552255,13104510,-895490,-6.396357142857142,Romance,5.3,114.0
16,"Oct 23, 2015",Suffragette,14000000,4702420,34044909,38747329,24747329,176.7666357142857,"Biography,Drama,History",6.9,106.0
18,"Dec 19, 2014",Mr. Turner,14000000,3958546,25187026,29145572,15145572,108.18265714285715,"Biography,Drama,History",6.8,150.0
22,"Aug 6, 2010",Flipped,14000000,1755212,4289993,6045205,-7954795,-56.819964285714285,"Comedy,Drama,Romance",7.7,90.0
22,"Aug 6, 2010",Flipped,14000000,1755212,4289993,6045205,-7954795,-56.819964285714285,"Drama,Thriller",6.0,90.0
25,"Jan 24, 2003",Amen,14000000,274299,274299,548598,-13451402,-96.08144285714286,Drama,5.6,72.0
25,"Jan 24, 2003",Amen,14000000,274299,274299,548598,-13451402,-96.08144285714286,"Drama,Musical,Romance",7.8,165.0
27,"Sep 30, 2011",Margaret,14000000,47185,623292,670477,-13329523,-95.21087857142857,Drama,6.5,150.0
28,"Nov 1, 2016",Reign of Assassins,14000000,0,11354230,11354230,-2645770,-18.89835714285714,"Action,Adventure",6.9,117.0
32,"Dec 31, 2008",Ca$h,13700000,0,11738256,11738256,-1961744,-14.319299270072994,"Crime,Thriller",6.0,108.0
33,"Mar 30, 1990",Teenage Mutant Ninja Turtles,13500000,135265915,202000000,337265915,323765915,2398.266037037037,"Action,Adventure,Comedy",5.8,101.0
36,"Oct 12, 2012",Seven Psychopaths,13500000,15024049,33035736,48059785,34559785,255.9984074074074,"Comedy,Crime",7.2,110.0
41,"Apr 1, 2011",The Last Godfather,13400000,164247,164247,328494,-13071506,-97.54855223880597,"Comedy,Crime,Romance",3.7,100.0
42,"Apr 4, 2014",Under the Skin,13300000,2614251,7229933,9844184,-3455816,-25.983578947368418,"Drama,Horror,Sci-Fi",6.3,108.0
44,"Sep 12, 2014",No Good Deed,13200000,52543632,54323210,106866842,93666842,709.5972878787878,"Action,Crime,Drama",5.6,84.0
46,"Dec 3, 2010",Black Swan,13000000,106954678,331266710,438221388,425221388,3270.933753846154,"Drama,Thriller",8.0,108.0
48,"Feb 11, 2011",Justin Bieber: Never Say Never,13000000,73013910,99034125,172048035,159048035,1223.446423076923,"Documentary,Music",1.6,105.0
49,"Jul 4, 2018",The First Purge,13000000,69488745,136617305,206106050,193106050,1485.4311538461538,"Action,Horror,Sci-Fi",5.1,98.0
50,"Mar 16, 2016",Miracles from Heaven,13000000,61705123,73798736,135503859,122503859,942.3373769230769,"Biography,Drama,Family",7.1,109.0
51,"Feb 11, 2000",Snow Day,13000000,60008303,62452927,122461230,109461230,842.0094615384616,"Action,Documentary,Drama",8.7,60.0
52,"Jan 23, 2004",The Butterfly Effect,13000000,57924679,95638592,153563271,140563271,1081.2559307692306,"Comedy,Crime,Drama",6.9,85.0
54,"Jun 24, 2016",The Shallows,13000000,55121623,118763442,173885065,160885065,1237.5774230769232,"Drama,Horror,Thriller",6.3,86.0
55,"Jul 17, 1987",RoboCop,13000000,53424681,53424681,106849362,93849362,721.9181692307692,"Action,Crime,Sci-Fi",6.2,117.0
58,"Feb 14, 2014",About Last Night,13000000,48637684,50445860,99083544,86083544,662.1811076923077,"Comedy,Romance",6.1,100.0
61,"Oct 10, 2014",St. Vincent,13000000,44137712,54837234,98974946,85974946,661.3457384615384,"Comedy,Drama",7.3,102.0
62,"Jul 2, 2014",Earth to Echo,13000000,38934842,42174545,81109387,68109387,523.9183615384615,"Adventure,Family,Sci-Fi",5.8,91.0
72,"Apr 10, 2015",Ex Machina,13000000,25440971,38358392,63799363,50799363,390.7643307692308,"Drama,Mystery,Sci-Fi",7.7,108.0
75,"Mar 11, 2016",Eye in the Sky,13000000,18704596,35402802,54107398,41107398,316.2107538461538,"Drama,Thriller,War",7.3,102.0
76,"Mar 22, 2013",Admission,13000000,18007317,18733666,36740983,23740983,182.62294615384616,"Comedy,Drama,Romance",5.7,107.0
77,"Sep 21, 2012",The Perks of Being a Wallflower,13000000,17742948,33069303,50812251,37812251,290.8634692307692,Drama,8.0,103.0
80,"Oct 16, 2015",Room,13000000,14677674,36262783,50940457,37940457,291.8496692307692,"Drama,Thriller",8.2,118.0
81,"Oct 16, 2015",Woodlawn,13000000,14394097,14403703,28797800,15797800,121.52153846153846,"Drama,Sport",6.5,123.0
85,"Jun 12, 1998",Dirty Work,13000000,10020081,10020081,20040162,7040162,54.15509230769231,"Crime,Drama",6.5,103.0
86,"Jul 17, 2015",Bajrangi Bhaijaan,13000000,8178001,121778347,129956348,116956348,899.6642153846153,"Action,Comedy,Drama",8.0,163.0
97,"Mar 26, 2010",Chloe,13000000,3075255,11831131,14906386,1906386,14.664507692307694,"Drama,Music,Romance",6.9,73.0
99,"Dec 4, 2015",Youth,13000000,2703296,24001573,26704869,13704869,105.42206923076922,"Drama,Family",6.6,75.0
99,"Dec 4, 2015",Youth,13000000,2703296,24001573,26704869,13704869,105.42206923076922,Drama,6.1,107.0
99,"Dec 4, 2015",Youth,13000000,2703296,24001573,26704869,13704869,105.42206923076922,"Comedy,Drama,Music",7.3,124.0
99,"Dec 4, 2015",Youth,13000000,2703296,24001573,26704869,13704869,105.42206923076922,Drama,7.3,124.0
99,"Dec 4, 2015",Youth,13000000,2703296,24001573,26704869,13704869,105.42206923076922,"Drama,Romance,War",7.1,135.0
3,"Jul 24, 2015",The Vatican Tapes,13000000,1784763,14929184,16713947,3713947,28.568823076923078,"Horror,Thriller",5.0,91.0
7,"Jul 29, 2011",Attack the Block,13000000,1024175,6459183,7483358,-5516642,-42.435707692307695,"Action,Comedy,Sci-Fi",6.7,88.0
8,"Aug 14, 2015",Brothers,13000000,656688,17856688,18513376,5513376,42.410584615384614,Drama,5.8,90.0
8,"Aug 14, 2015",Brothers,13000000,656688,17856688,18513376,5513376,42.410584615384614,Documentary,7.7,100.0
8,"Aug 14, 2015",Brothers,13000000,656688,17856688,18513376,5513376,42.410584615384614,"Action,Drama,Sport",6.7,156.0
8,"Aug 14, 2015",Brothers,13000000,656688,17856688,18513376,5513376,42.410584615384614,Documentary,7.5,68.0
8,"Aug 14, 2015",Brothers,13000000,656688,17856688,18513376,5513376,42.410584615384614,Drama,7.6,93.0
8,"Aug 14, 2015",Brothers,13000000,656688,17856688,18513376,5513376,42.410584615384614,"Action,Drama,War",5.2,95.0
11,"Jun 18, 2010",The Killer Inside Me,13000000,217277,3617277,3834554,-9165446,-70.50343076923077,"Crime,Drama,Horror",6.1,109.0
12,"Mar 30, 2012",Womb,13000000,0,0,0,-13000000,-100.0,"Drama,Romance,Sci-Fi",6.4,111.0
14,"Mar 15, 2013",The Call,12800000,51872378,69821476,121693854,108893854,850.733234375,"Crime,Drama,Horror",6.7,94.0
14,"Mar 15, 2013",The Call,12800000,51872378,69821476,121693854,108893854,850.733234375,Documentary,7.9,25.0
14,"Mar 15, 2013",The Call,12800000,51872378,69821476,121693854,108893854,850.733234375,Thriller,6.6,109.0
16,"Sep 12, 2014",The Drop,12600000,10724389,19054534,29778923,17178923,136.34065873015874,"Crime,Drama",7.1,106.0
18,"Sep 3, 2010",Machete,12500000,26593646,46370970,72964616,60464616,483.71692800000005,"Action,Crime,Thriller",6.6,105.0
28,"Oct 15, 2010",Conviction,12500000,6797696,11826980,18624676,6124676,48.997408,"Biography,Crime,Drama",7.2,107.0
28,"Oct 15, 2010",Conviction,12500000,6797696,11826980,18624676,6124676,48.997408,Drama,7.0,110.0
32,"Dec 17, 2010",Casino Jack,12500000,2039869,2272186,4312055,-8187945,-65.50356000000001,"Biography,Comedy,Crime",6.2,108.0
37,"Oct 5, 2012",The Paperboy,12500000,677200,4027663,4704863,-7795137,-62.361096,"Crime,Drama,Mystery",5.8,107.0
39,"May 4, 2012",A Little Bit of Heaven,12500000,10011,1100287,1110298,-11389702,-91.117616,"Comedy,Drama,Fantasy",6.3,106.0
43,"Jun 6, 2014",The Fault in Our Stars,12000000,124872350,307166834,432039184,420039184,3500.326533333333,"Drama,Romance",7.7,126.0
45,"Apr 20, 2012",Think Like a Man,12000000,91547205,113373764,204920969,192920969,1607.6747416666667,"Comedy,Romance",6.6,122.0
47,"Dec 12, 1986",The Golden Child,12000000,79817937,79817937,159635874,147635874,1230.29895,Drama,5.7,86.0
52,"Feb 24, 2012",Act of Valor,12000000,70012847,82497035,152509882,140509882,1170.9156833333334,"Action,Adventure,Drama",6.5,110.0
53,"Feb 8, 1985",Witness,12000000,65532576,65532576,131065152,119065152,992.2096,"Action,Crime,Drama",5.3,96.0
53,"Feb 8, 1985",Witness,12000000,65532576,65532576,131065152,119065152,992.2096,Thriller,7.1,129.0
54,"Aug 11, 2006",Step Up,12000000,65328121,110989157,176317278,164317278,1369.3106500000001,"Biography,Documentary,Drama",7.7,55.0
55,"Feb 3, 2012",Chronicle,12000000,64575175,123681790,188256965,176256965,1468.8080416666667,"Drama,Sci-Fi,Thriller",7.1,84.0
58,"Mar 2, 2012",Project X,12000000,54731865,103028188,157760053,145760053,1214.6671083333333,Comedy,6.7,88.0
59,"Nov 10, 2017","Three Billboards Outside Ebbing, Missouri",12000000,54513740,160191915,214705655,202705655,1689.2137916666666,"Crime,Drama",8.2,115.0
60,"Nov 25, 2016",Lion,12000000,51739495,149570720,201310215,189310215,1577.585125,"Biography,Drama",8.1,118.0
60,"Nov 25, 2016",Lion,12000000,51739495,149570720,201310215,189310215,1577.585125,"Action,Drama,Romance",3.6,143.0
61,"May 4, 2018",Overboard,12000000,50316123,85369830,135685953,123685953,1030.716275,"Comedy,Romance",5.9,112.0
65,"Nov 22, 2013",Philomena,12000000,37709979,98963392,136673371,124673371,1038.9447583333333,"Biography,Comedy,Drama",7.6,98.0
67,"Feb 15, 2002",Crossroads,12000000,37188667,57000000,94188667,82188667,684.9055583333334,"Action,Crime,Drama",7.8,87.0
67,"Feb 15, 2002",Crossroads,12000000,37188667,57000000,94188667,82188667,684.9055583333334,"Drama,Mystery,War",6.1,116.0
67,"Feb 15, 2002",Crossroads,12000000,37188667,57000000,94188667,82188667,684.9055583333334,Documentary,8.7,65.0
68,"Jul 24, 2015",Paper Towns,12000000,32000304,85450484,117450788,105450788,878.7565666666668,"Comedy,Drama,Mystery",6.3,109.0
77,"Aug 12, 2016",Hell or High Water,12000000,27007844,37584304,64592148,52592148,438.26790000000005,"Action,Crime,Drama",7.6,102.0
79,"Jul 5, 2012",Katy Perry: Part of Me,12000000,25326071,32700439,58026510,46026510,383.55424999999997,"Documentary,Music",5.9,93.0
80,"Dec 12, 2014",Top Five,12000000,25317379,26001741,51319120,39319120,327.65933333333334,"Comedy,Romance",6.4,102.0
83,"Jun 15, 1979",Prophecy,12000000,22673340,22673340,45346680,33346680,277.889,Mystery,6.5,119.0
83,"Jun 15, 1979",Prophecy,12000000,22673340,22673340,45346680,33346680,277.889,Drama,5.8,92.0
84,"Jan 30, 2015",Project Almanac,12000000,22348241,32909437,55257678,43257678,360.48065,"Drama,Mystery,Sci-Fi",6.4,106.0
85,"May 14, 2010",Just Wright,12000000,21540363,21867665,43408028,31408028,261.73356666666666,"Comedy,Romance,Sport",5.9,100.0
91,"Nov 15, 2013",Nebraska,12000000,17654912,24761360,42416272,30416272,253.46893333333333,"Adventure,Comedy,Drama",7.7,115.0
94,"Dec 9, 2011",Young Adult,12000000,16311571,22750356,39061927,27061927,225.51605833333332,"Comedy,Drama",6.3,94.0
95,"Nov 1, 2013",About Time,12000000,15323921,89309178,104633099,92633099,771.9424916666667,"Comedy,Drama,Fantasy",7.8,123.0
96,"Dec 14, 2018",If Beale Street Could Talk,12000000,14915773,19859167,34774940,22774940,189.79116666666667,"Drama,Romance",7.2,119.0
97,"Jul 14, 2017",Wish Upon,12000000,14301505,23477345,37778850,25778850,214.82375,"Drama,Fantasy,Horror",5.0,90.0
4,"Apr 21, 2017",Unforgettable,12000000,11368012,16221211,27589223,15589223,129.91019166666666,Documentary,5.9,88.0
4,"Apr 21, 2017",Unforgettable,12000000,11368012,16221211,27589223,15589223,129.91019166666666,"Drama,Romance",5.5,130.0
4,"Apr 21, 2017",Unforgettable,12000000,11368012,16221211,27589223,15589223,129.91019166666666,"Drama,Thriller",5.1,100.0
4,"Apr 21, 2017",Unforgettable,12000000,11368012,16221211,27589223,15589223,129.91019166666666,"Drama,Romance",7.3,113.0
7,"Oct 13, 2017",Marshall,12000000,10051659,10116816,20168475,8168475,68.07062499999999,"Biography,Crime,Drama",7.2,118.0
9,"Sep 14, 2012",Arbitrage,12000000,7919574,35830713,43750287,31750287,264.585725,"Drama,Thriller",6.6,107.0
11,"May 12, 2000",Screwed,12000000,6982680,6982680,13965360,1965360,16.378,"Crime,Drama",5.7,110.0
11,"May 12, 2000",Screwed,12000000,6982680,6982680,13965360,1965360,16.378,"Comedy,Romance",4.4,96.0
11,"May 12, 2000",Screwed,12000000,6982680,6982680,13965360,1965360,16.378,"Comedy,Drama,Romance",6.3,100.0
13,"Sep 3, 1993",Fortress,12000000,6730578,46730578,53461156,41461156,345.50963333333334,"Documentary,Drama,News",7.0,70.0
14,"Jun 1, 2012",For Greater Glory: The True Story of Cristiada,12000000,5669081,10026255,15695336,3695336,30.794466666666665,"Drama,History,War",6.6,145.0
27,"Mar 19, 1999",Ravenous,12000000,2062406,2062406,4124812,-7875188,-65.62656666666666,"Drama,Horror,Sci-Fi",5.9,104.0
29,"Mar 1, 2013",Stoker,12000000,1703125,12034913,13738038,1738038,14.48365,"Drama,Thriller",6.8,99.0
32,"Mar 11, 2011",Kill the Irishman,12000000,1188194,1188194,2376388,-9623612,-80.19676666666666,"Biography,Crime,Drama",7.1,106.0
34,"Apr 20, 2012",Darling Companion,12000000,793352,1200346,1993698,-10006302,-83.38584999999999,"Comedy,Drama,Romance",5.1,103.0
36,"Jul 20, 2001",Brother,12000000,450594,450594,901188,-11098812,-92.4901,"Drama,Family,Sport",7.4,97.0
36,"Jul 20, 2001",Brother,12000000,450594,450594,901188,-11098812,-92.4901,"Comedy,Drama,Thriller",5.9,115.0
46,"Oct 9, 2015",Trash,12000000,17484,6553186,6570670,-5429330,-45.244416666666666,"Adventure,Crime,Drama",7.2,114.0
47,"Aug 19, 2011",5 Days of War,12000000,17479,87793,105272,-11894728,-99.12273333333333,"Action,Drama,War",5.6,113.0
48,"Nov 11, 2015",10 Days in a Madhouse,12000000,14616,14616,29232,-11970768,-99.7564,Drama,6.7,111.0
54,"Oct 3, 2014",Drive Hard,12000000,0,0,0,-12000000,-100.0,"Action,Comedy,Crime",4.4,92.0
56,"Jun 5, 2009",Home,12000000,0,0,0,-12000000,-100.0,Drama,6.0,76.0
56,"Jun 5, 2009",Home,12000000,0,0,0,-12000000,-100.0,Drama,7.5,127.0
56,"Jun 5, 2009",Home,12000000,0,0,0,-12000000,-100.0,"Adventure,Animation,Comedy",6.6,94.0
56,"Jun 5, 2009",Home,12000000,0,0,0,-12000000,-100.0,"Drama,Romance",6.8,90.0
56,"Jun 5, 2009",Home,12000000,0,0,0,-12000000,-100.0,Drama,7.0,112.0
56,"Jun 5, 2009",Home,12000000,0,0,0,-12000000,-100.0,"Drama,Horror,Thriller",3.9,87.0
56,"Jun 5, 2009",Home,12000000,0,0,0,-12000000,-100.0,Drama,7.2,103.0
56,"Jun 5, 2009",Home,12000000,0,0,0,-12000000,-100.0,"Drama,Romance,Thriller",8.4,71.0
57,"Sep 23, 2016",The Dressmaker,11900000,2022115,24041617,26063732,14163732,119.02295798319327,"Comedy,Drama",7.1,119.0
60,"Nov 20, 2015",Carol,11800000,12711491,42843521,55555012,43755012,370.80518644067797,"Drama,Romance",7.2,118.0
61,"Apr 21, 1989",Pet Sematary,11500000,57469179,57469179,114938358,103438358,899.4639826086957,"Horror,Mystery,Thriller",6.0,101.0
62,"Jan 22, 2016",Dirty Grandpa,11500000,35593113,105078449,140671562,129171562,1123.2309739130435,Comedy,5.9,102.0
68,"Dec 10, 2010",The Fighter,11000000,93617009,129262388,222879397,211879397,1926.1763363636362,"Biography,Drama,Sport",7.8,116.0
73,"Aug 22, 2014",If I Stay,11000000,50474843,78356170,128831013,117831013,1071.1910272727273,"Drama,Fantasy,Music",6.8,107.0
79,"Nov 4, 2015",Brooklyn,11000000,38322743,62076141,100398884,89398884,812.7171272727272,"Drama,Romance",7.5,117.0
79,"Nov 4, 2015",Brooklyn,11000000,38322743,62076141,100398884,89398884,812.7171272727272,"Drama,Music,Musical",6.4,83.0
81,"Apr 1, 2015",Woman in Gold,11000000,33307793,58586407,91894200,80894200,735.4018181818182,"Biography,Drama,History",7.3,109.0
83,"Dec 8, 2017","I, Tonya",11000000,30014534,53797409,83811943,72811943,661.9267545454545,"Biography,Comedy,Drama",7.5,120.0
90,"Jan 11, 2013",Quartet,11000000,18388357,56178935,74567292,63567292,577.8844727272727,"Comedy,Drama",6.8,94.0
94,"Dec 6, 2013",Inside Llewyn Davis,11000000,13248209,32943247,46191456,35191456,319.9223272727273,"Drama,Music",7.5,104.0
98,"May 10, 2013",Peeples,11000000,9177065,9307166,18484231,7484231,68.03846363636363,"Comedy,Romance",5.3,95.0
100,"Jul 6, 2016",Sultan,11000000,5599781,72989781,78589562,67589562,614.4505636363637,"Action,Drama,Sport",7.1,170.0
2,"Sep 26, 2003",The Gospel of John,11000000,4068087,4234355,8302442,-2697558,-24.523254545454545,Drama,7.8,160.0
11,"Aug 26, 2011",Brighton Rock,11000000,229653,229653,459306,-10540694,-95.82449090909091,"Crime,Drama,Thriller",5.7,111.0
14,"May 4, 2012",LOL,11000000,0,10431506,10431506,-568494,-5.168127272727273,"Comedy,Drama,Romance",4.4,97.0
15,"Feb 5, 2016",Misconduct,11000000,0,2352511,2352511,-8647489,-78.61353636363636,"Crime,Drama,Mystery",5.3,106.0
16,"Dec 31, 2019",Eli,11000000,0,0,0,-11000000,-100.0,Comedy,4.7,154.0
22,"Jun 4, 1982",Poltergeist,10700000,74706019,121706019,196412038,185712038,1735.6265233644858,"Horror,Thriller",4.9,93.0
25,"Dec 6, 2013",The Last Days on Mars,10600000,24084,261364,285448,-10314552,-97.30709433962265,"Adventure,Horror,Sci-Fi",5.5,98.0
33,"Feb 18, 1983",Lovesick,10100000,10143618,10143618,20287236,10187236,100.86372277227721,"Comedy,Fantasy,Romance",5.0,90.0
33,"Feb 18, 1983",Lovesick,10100000,10143618,10143618,20287236,10187236,100.86372277227721,"Comedy,Romance",5.2,85.0
33,"Feb 18, 1983",Lovesick,10100000,10143618,10143618,20287236,10187236,100.86372277227721,"Drama,Romance",4.7,93.0
34,"Apr 30, 2010",Housefull,10100000,1183658,18726300,19909958,9809958,97.12829702970296,Comedy,5.5,144.0
36,"Oct 19, 2018",Halloween,10000000,159342015,254900667,414242682,404242682,4042.42682,"Horror,Thriller",6.6,106.0
42,"Jul 1, 2016",The Purge: Election Year,10000000,79042440,118514727,197557167,187557167,1875.57167,"Action,Horror,Sci-Fi",6.0,108.0
43,"May 18, 2018",Book Club,10000000,68566296,91113683,159679979,149679979,1496.79979,Documentary,6.6,72.0
43,"May 18, 2018",Book Club,10000000,68566296,91113683,159679979,149679979,1496.79979,"Comedy,Drama,Romance",6.1,104.0
45,"Jan 5, 2018",Insidious: The Last Key,10000000,67745330,167885588,235630918,225630918,2256.3091799999997,"Horror,Mystery,Thriller",5.7,103.0
53,"Nov 3, 2017",Lady Bird,10000000,48958273,78610769,127569042,117569042,1175.69042,"Comedy,Drama",7.4,94.0
55,"May 4, 2012",The Best Exotic Marigold Hotel,10000000,46383639,134639780,181023419,171023419,1710.23419,"Comedy,Drama,Romance",7.3,124.0
56,"Jun 8, 2018",Hereditary,10000000,44069456,70133905,114203361,104203361,1042.03361,"Drama,Horror,Mystery",7.3,127.0
57,"Mar 16, 2018","Love, Simon",10000000,40826341,65520633,106346974,96346974,963.46974,"Comedy,Drama,Romance",7.6,110.0
61,"Oct 27, 2017",Jigsaw,10000000,38052832,102445196,140498028,130498028,1304.98028,"Crime,Horror,Mystery",5.8,92.0
68,"Jan 22, 2016",The Boy,10000000,35819556,68220952,104040508,94040508,940.40508,"Drama,Horror,Thriller",5.4,105.0
68,"Jan 22, 2016",The Boy,10000000,35819556,68220952,104040508,94040508,940.40508,"Horror,Mystery,Thriller",6.0,97.0
69,"Oct 4, 1985",Commando,10000000,35073978,35073978,70147956,60147956,601.47956,"Action,Thriller",6.1,124.0
70,"May 19, 2017","Everything, Everything",10000000,34121140,61603136,95724276,85724276,857.24276,"Drama,Romance",6.4,96.0
71,"Sep 17, 2010",Devil,10000000,33679655,63354114,97033769,87033769,870.3376900000001,"Horror,Mystery,Thriller",6.2,80.0
73,"Mar 6, 2015",The Second Best Exotic Marigold Hotel,10000000,33078266,90384306,123462572,113462572,1134.62572,"Comedy,Drama",6.6,122.0
75,"Apr 28, 2017",How to Be a Latin Lover,10000000,32149404,62556228,94705632,84705632,847.0563200000001,"Comedy,Drama",5.9,115.0
78,"Dec 19, 2003",Calendar Girls,10000000,31011616,93074616,124086232,114086232,1140.86232,Drama,4.2,131.0
80,"Aug 10, 2018",Slender Man,10000000,30564825,51723644,82288469,72288469,722.88469,"Horror,Mystery,Thriller",3.2,93.0
80,"Aug 10, 2018",Slender Man,10000000,30564825,51723644,82288469,72288469,722.88469,"Adventure,Comedy,Horror",5.9,52.0
85,"Sep 9, 2016",When the Bough Breaks,10000000,29747603,30768449,60516052,50516052,505.16052,"Crime,Drama,Horror",5.1,107.0
91,"Aug 21, 2015",Sinister 2,10000000,27740955,54104225,81845180,71845180,718.4517999999999,"Horror,Mystery,Thriller",5.3,97.0
92,"Jan 8, 2016",The Forest,10000000,26594261,40749230,67343491,57343491,573.4349100000001,"Horror,Thriller",3.5,98.0
92,"Jan 8, 2016",The Forest,10000000,26594261,40749230,67343491,57343491,573.4349100000001,"Horror,Mystery,Thriller",4.8,93.0
92,"Jan 8, 2016",The Forest,10000000,26594261,40749230,67343491,57343491,573.4349100000001,"Documentary,History",7.1,72.0
92,"Jan 8, 2016",The Forest,10000000,26594261,40749230,67343491,57343491,573.4349100000001,"Drama,Fantasy,Horror",6.5,109.0
96,"Aug 17, 2012",Sparkle,10000000,24397469,24660323,49057792,39057792,390.57792,"Drama,Music",5.7,116.0
97,"Oct 14, 2016",Kevin Hart: What Now?,10000000,23591043,23591043,47182086,37182086,371.82086,"Comedy,Documentary",5.9,96.0
98,"Apr 26, 2013",Mud,10000000,21590086,31556959,53147045,43147045,431.47045,Drama,7.4,130.0
98,"Apr 26, 2013",Mud,10000000,21590086,31556959,53147045,43147045,431.47045,Drama,6.5,105.0
99,"Nov 12, 2010",Skyline,10000000,21416355,68264973,89681328,79681328,796.8132800000001,"Action,Sci-Fi,Thriller",4.4,92.0
100,"Dec 1, 2017",The Disaster Artist,10000000,21120616,28717667,49838283,39838283,398.38283,"Biography,Comedy,Drama",7.4,104.0
1,"Sep 16, 2016",Blair Witch,10000000,20777061,38985577,59762638,49762638,497.62638,"Horror,Mystery,Thriller",5.0,89.0
7,"Oct 23, 2015",Paranormal Activity: The Ghost Dimension,10000000,18297124,77959374,96256498,86256498,862.56498,"Horror,Mystery,Thriller",4.6,88.0
14,"Jun 17, 2005",The Perfect Man,10000000,16535005,19535005,36070010,26070010,260.70009999999996,"Drama,Romance",6.2,90.0
14,"Jun 17, 2005",The Perfect Man,10000000,16535005,19535005,36070010,26070010,260.70009999999996,Romance,5.2,92.0
17,"Oct 7, 2016",The Birth of a Nation,10000000,15861566,16891011,32752577,22752577,227.52577,"Biography,Drama,History",6.4,120.0
22,"Nov 23, 2011",My Week with Marilyn,10000000,14597405,34240572,48837977,38837977,388.37977,"Biography,Drama",7.0,99.0
23,"Dec 25, 2014",Big Eyes,10000000,14482031,27317872,41799903,31799903,317.99903,"Biography,Crime,Drama",7.0,106.0
28,"Dec 19, 2000",The Gift,10000000,12008642,44567606,56576248,46576248,465.76248,"Action,Drama,Thriller",7.5,113.0
28,"Dec 19, 2000",The Gift,10000000,12008642,44567606,56576248,46576248,465.76248,"Drama,Mystery,Thriller",7.1,108.0
28,"Dec 19, 2000",The Gift,10000000,12008642,44567606,56576248,46576248,465.76248,Drama,6.0,82.0
28,"Dec 19, 2000",The Gift,10000000,12008642,44567606,56576248,46576248,465.76248,Documentary,6.2,56.0
28,"Dec 19, 2000",The Gift,10000000,12008642,44567606,56576248,46576248,465.76248,Drama,8.0,118.0
33,"Jul 23, 1999",Drop Dead Gorgeous,10000000,10571408,10571408,21142816,11142816,111.42815999999999,Comedy,4.8,100.0
34,"Apr 5, 2019",The Best of Enemies,10000000,10205616,10205616,20411232,10411232,104.11232,"Biography,Drama,History",6.8,133.0
39,"Jan 25, 2013",Movie 43,10000000,8840453,31164747,40005200,30005200,300.05199999999996,Comedy,4.3,94.0
40,"Oct 19, 2018",Can You Ever Forgive Me?,10000000,8803865,11752387,20556252,10556252,105.56251999999999,"Biography,Comedy,Crime",7.2,106.0
42,"May 21, 2010",MacGruber,10000000,8525600,8629895,17155495,7155495,71.55494999999999,"Action,Comedy,Romance",5.5,90.0
44,"Mar 14, 2014",Bad Words,10000000,7779614,7843145,15622759,5622759,56.227590000000006,"Comedy,Drama",6.7,89.0
45,"Mar 27, 2015",While We're Young,10000000,7582065,17503828,25085893,15085893,150.85893,"Comedy,Drama,Mystery",6.3,97.0
47,"Oct 24, 2001",Bones,10000000,7316658,8378853,15695511,5695511,56.95511,Drama,6.6,88.0
48,"Jun 22, 2012",Seeking a Friend for the End of the World,10000000,7078738,11766959,18845697,8845697,88.45697,"Adventure,Comedy,Drama",6.7,101.0
50,"Nov 11, 2016",Shut In,10000000,6900335,11360665,18261000,8261000,82.61,"Drama,Mystery,Thriller",4.7,91.0
51,"Feb 11, 2011",Cedar Rapids,10000000,6861102,7862131,14723233,4723233,47.23233,Comedy,6.3,87.0
52,"Nov 30, 2012",The Collection,10000000,6810754,8890094,15700848,5700848,57.00847999999999,"Action,Horror,Thriller",6.1,82.0
59,"Mar 20, 2015",Danny Collins,10000000,5637066,8465845,14102911,4102911,41.02911,"Biography,Comedy,Drama",7.0,106.0
61,"Apr 5, 2000",Black and White,10000000,5241315,5241315,10482630,482630,4.8263,Drama,6.2,90.0
63,"Oct 26, 2001",On the Line,10000000,4365455,4690802,9056257,-943743,-9.437429999999999,Documentary,8.7,68.0
63,"Oct 26, 2001",On the Line,10000000,4365455,4690802,9056257,-943743,-9.437429999999999,"Comedy,Drama",6.3,76.0
64,"Jun 15, 2018",Gotti,10000000,4286367,6089100,10375467,375467,3.7546700000000004,"Biography,Crime,Drama",4.8,112.0
65,"Mar 16, 2012","Jeff, Who Lives at Home",10000000,4269426,4708127,8977553,-1022447,-10.22447,"Comedy,Drama",6.5,83.0
66,"Sep 30, 2016",Denial,10000000,4073448,9263940,13337388,3337388,33.37388,"Biography,Drama",6.7,109.0
66,"Sep 30, 2016",Denial,10000000,4073448,9263940,13337388,3337388,33.37388,Documentary,7.4,93.0
67,"Apr 29, 2016",The Man Who Knew Infinity,10000000,3877922,12382122,16260044,6260044,62.60044,"Biography,Drama",7.2,108.0
68,"Oct 14, 2016",Max Steel,10000000,3818664,4563080,8381744,-1618256,-16.18256,"Action,Adventure,Family",4.6,92.0
72,"Feb 4, 1994",Romeo Is Bleeding,10000000,3275585,3275585,6551170,-3448830,-34.4883,"Biography,Documentary,Drama",8.1,93.0
74,"Nov 14, 2014",Rosewater,10000000,3128941,3185717,6314658,-3685342,-36.85342,"Biography,Drama",6.6,103.0
78,"Sep 9, 2011",Bucky Larson: Born to Be a Star,10000000,2529395,2529395,5058790,-4941210,-49.412099999999995,Comedy,3.3,97.0
81,"May 3, 2013",The Iceman,10000000,1930282,3623609,5553891,-4446109,-44.46109,"Biography,Crime,Drama",6.9,106.0
82,"Jun 5, 2015",Testament of Youth,10000000,1822250,6646669,8468919,-1531081,-15.31081,"Biography,Drama,History",7.3,129.0
83,"Apr 21, 2017",Free Fire,10000000,1799322,3793739,5593061,-4406939,-44.069390000000006,"Action,Comedy,Crime",6.4,91.0
84,"Jun 24, 2011",A Better Life,10000000,1759252,1884251,3643503,-6356497,-63.564969999999995,"Drama,Romance",7.2,98.0
84,"Jun 24, 2011",A Better Life,10000000,1759252,1884251,3643503,-6356497,-63.564969999999995,Drama,6.6,110.0
86,"Feb 4, 2000",Gun Shy,10000000,1638202,1638202,3276404,-6723596,-67.23595999999999,"Action,Adventure,Comedy",4.1,92.0
88,"Apr 16, 2010",The Joneses,10000000,1475746,3541565,5017311,-4982689,-49.82689,"Comedy,Drama",6.9,117.0
88,"Apr 16, 2010",The Joneses,10000000,1475746,3541565,5017311,-4982689,-49.82689,"Biography,Documentary",5.9,80.0
90,"Jul 27, 2012",Killer Joe,10000000,1291645,4659110,5950755,-4049245,-40.492450000000005,"Crime,Drama,Thriller",6.7,102.0
91,"Jun 2, 2017",Churchill,10000000,1279681,7582196,8861877,-1138123,-11.38123,"Biography,Drama,History",6.3,105.0
93,"Mar 21, 2014",50 to 1,10000000,1069454,1069454,2138908,-7861092,-78.61092,Drama,6.6,110.0
99,"Jan 20, 2012",Coriolanus,10000000,749641,2179623,2929264,-7070736,-70.70736,"Drama,Thriller,War",6.1,123.0
99,"Jan 20, 2012",Coriolanus,10000000,749641,2179623,2929264,-7070736,-70.70736,"Drama,History,War",8.7,192.0
100,"Oct 4, 2013",Parkland,10000000,641439,1616353,2257792,-7742208,-77.42208000000001,"Drama,History,Mystery",6.4,93.0
11,"May 3, 2013","Cinco de Mayo, La Batalla",10000000,173472,173472,346944,-9653056,-96.53056,"Drama,History,War",6.2,125.0
12,"Oct 29, 2010",Welcome to the Rileys,10000000,152857,355919,508776,-9491224,-94.91224,Drama,7.0,110.0
13,"Sep 9, 2016",Kicks,10000000,150191,150191,300382,-9699618,-96.99618,"Adventure,Drama",6.3,80.0
15,"Jun 1, 2012",High School,10000000,139034,248133,387167,-9612833,-96.12832999999999,Comedy,5.8,99.0
17,"Jul 14, 2006",Edmond,10000000,131719,241719,373438,-9626562,-96.26562,"Comedy,Drama,History",7.5,110.0
20,"Feb 19, 2010",Blood Done Sign My Name,10000000,109383,109383,218766,-9781234,-97.81233999999999,Drama,6.6,128.0
22,"Oct 23, 2009",Motherhood,10000000,93388,723388,816776,-9183224,-91.83224,"Drama,Romance",4.6,74.0
24,"Nov 7, 2014",Elsa & Fred,10000000,67657,197901,265558,-9734442,-97.34442,"Comedy,Drama,Romance",6.5,93.0
27,"Jul 10, 2015",Strangerland,10000000,17472,161097,178569,-9821431,-98.21431000000001,"Drama,Mystery,Thriller",5.2,112.0
32,"Dec 26, 2014",Barbecue,10000000,388,247565,247953,-9752047,-97.52047,Comedy,6.1,98.0
32,"Dec 26, 2014",Barbecue,10000000,388,247565,247953,-9752047,-97.52047,Documentary,6.5,102.0
33,"Dec 31, 2010",The Reef,10000000,0,15037867,15037867,5037867,50.37867,"Adventure,Drama,Horror",5.8,94.0
35,"Jul 21, 2015",American Heist,10000000,0,2341218,2341218,-7658782,-76.58782,"Action,Crime,Drama",5.1,94.0
36,"Oct 8, 2010",It's a Wonderful Afterlife,10000000,0,1642939,1642939,-8357061,-83.57061,"Comedy,Drama,Fantasy",5.4,100.0
39,"Sep 26, 2014",Plastic,10000000,0,575371,575371,-9424629,-94.24629,Horror,6.2,80.0
39,"Sep 26, 2014",Plastic,10000000,0,575371,575371,-9424629,-94.24629,Thriller,2.5,78.0
39,"Sep 26, 2014",Plastic,10000000,0,575371,575371,-9424629,-94.24629,"Action,Comedy,Crime",6.0,102.0
40,"Mar 10, 2015",Jungle Shuffle,10000000,0,360898,360898,-9639102,-96.39102000000001,"Adventure,Animation",4.8,85.0
43,"Dec 31, 2009",Good Intentions,10000000,0,0,0,-10000000,-100.0,Comedy,5.2,84.0
45,"Apr 13, 2012",Detention,10000000,0,0,0,-10000000,-100.0,"Horror,Thriller",3.0,81.0
45,"Apr 13, 2012",Detention,10000000,0,0,0,-10000000,-100.0,"Comedy,Horror,Mystery",5.8,93.0
46,"Feb 7, 2014",Nurse 3D,10000000,0,0,0,-10000000,-100.0,"Horror,Thriller",4.6,84.0
47,"May 19, 2015",Into the Grizzly Maze,10000000,0,0,0,-10000000,-100.0,"Action,Adventure,Drama",5.3,94.0
48,"Sep 22, 2017",Friend Request,9900000,3759078,11310835,15069913,5169913,52.22134343434344,Thriller,4.0,91.0
48,"Sep 22, 2017",Friend Request,9900000,3759078,11310835,15069913,5169913,52.22134343434344,"Horror,Thriller",5.3,92.0
48,"Sep 22, 2017",Friend Request,9900000,3759078,11310835,15069913,5169913,52.22134343434344,Horror,4.9,106.0
49,"Apr 30, 2010",Gunless,9900000,458054,458054,916108,-8983892,-90.74638383838384,"Action,Comedy,Drama",6.5,89.0
51,"Dec 19, 2012",Amour,9700000,6738954,36787044,43525998,33825998,348.72162886597937,"Drama,Romance",7.9,127.0
56,"Dec 21, 2016",Dangal,9500000,12391761,294654618,307046379,297546379,3132.067147368421,"Action,Biography,Drama",8.5,161.0
57,"Mar 19, 2010",The Runaways,9500000,3573673,5278632,8852305,-647695,-6.817842105263158,"Biography,Drama,Music",6.6,106.0
57,"Mar 19, 2010",The Runaways,9500000,3573673,5278632,8852305,-647695,-6.817842105263158,Adventure,9.2,108.0
59,"Dec 31, 2013",Re-Kill,9500000,0,0,0,-9500000,-100.0,"Action,Horror",5.0,88.0
62,"Nov 11, 2011",Melancholia,9400000,3030848,21817298,24848146,15448146,164.34197872340425,"Drama,Sci-Fi",7.2,135.0
62,"Nov 11, 2011",Melancholia,9400000,3030848,21817298,24848146,15448146,164.34197872340425,"Drama,Mystery,Romance",3.3,75.0
64,"Nov 13, 2012",Jab Tak Hai Jaan,9200000,3047539,5806666,8854205,-345795,-3.758641304347826,"Drama,Romance",6.8,176.0
66,"May 21, 2010",Kites,9200000,1685269,17155193,18840462,9640462,104.78763043478261,"Action,Drama,Romance",6.1,123.0
67,"Dec 31, 2011",Red Dog,9100000,0,20927794,20927794,11827794,129.97575824175826,"Biography,Comedy,Drama",7.4,92.0
67,"Dec 31, 2011",Red Dog,9100000,0,20927794,20927794,11827794,129.97575824175826,"Action,Drama,History",7.2,99.0
71,"Jul 18, 2014",The Purge: Anarchy,9000000,71562550,111534881,183097431,174097431,1934.4159000000002,"Action,Horror,Sci-Fi",6.5,103.0
75,"Oct 21, 2016",Ouija: Origin of Evil,9000000,35144505,81831866,116976371,107976371,1199.7374555555557,"Drama,Horror,Mystery",6.1,99.0
78,"Feb 13, 2019",Happy Death Day 2U,9000000,28051045,64179495,92230540,83230540,924.7837777777777,"Drama,Horror,Mystery",6.3,100.0
80,"Jan 30, 2015",Black or White,9000000,21571189,21971021,43542210,34542210,383.8023333333333,Drama,6.6,121.0
83,"Oct 13, 2000",The Contender,9000000,17804273,17804273,35608546,26608546,295.6505111111111,"Documentary,Drama,Sport",6.7,74.0
86,"Nov 18, 2016",The Edge of Seventeen,9000000,14431633,19096003,33527636,24527636,272.52928888888886,"Comedy,Drama",7.3,104.0
87,"Dec 2, 2016",Jackie,9000000,13960394,36588512,50548906,41548906,461.6545111111111,"Biography,Drama,History",6.7,100.0
87,"Dec 2, 2016",Jackie,9000000,13960394,36588512,50548906,41548906,461.6545111111111,Action,7.1,126.0
87,"Dec 2, 2016",Jackie,9000000,13960394,36588512,50548906,41548906,461.6545111111111,"Comedy,Drama",6.8,100.0
90,"Aug 12, 2011",Glee: The 3D Concert Movie,9000000,11862398,17462398,29324796,20324796,225.83106666666666,"Documentary,Music",5.4,84.0
92,"Nov 4, 2016",Loving,9000000,7710234,12898064,20608298,11608298,128.98108888888888,"Drama,Romance",7.1,105.0
92,"Nov 4, 2016",Loving,9000000,7710234,12898064,20608298,11608298,128.98108888888888,"Biography,Drama,Romance",7.0,123.0
92,"Nov 4, 2016",Loving,9000000,7710234,12898064,20608298,11608298,128.98108888888888,"Drama,Romance",5.3,105.0
1,"Sep 29, 2000",Beautiful,9000000,3134509,3134509,6269018,-2730982,-30.344244444444445,"Biography,Drama,Family",7.5,120.0
2,"Jun 1, 2007",Gracie,9000000,2956339,3922043,6878382,-2121618,-23.573533333333334,"Crime,Drama,Fantasy",7.0,71.0
3,"Mar 22, 2013",The Sapphires,9000000,2450867,20395040,22845907,13845907,153.8434111111111,"Biography,Comedy,Drama",7.0,103.0
4,"Aug 26, 2016",Greater,9000000,2000093,2000093,4000186,-4999814,-55.55348888888889,"Biography,Family,Sport",7.2,130.0
5,"Dec 25, 2018",Destroyer,9000000,1533324,3681096,5214420,-3785580,-42.062,"Action,Crime,Drama",6.2,121.0
12,"May 6, 2016",Dheepan,9000000,248795,7704357,7953152,-1046848,-11.631644444444444,"Crime,Drama",7.2,115.0
14,"Oct 25, 2002",All or Nothing,9000000,184255,184255,368510,-8631490,-95.90544444444444,Thriller,8.2,71.0
14,"Oct 25, 2002",All or Nothing,9000000,184255,184255,368510,-8631490,-95.90544444444444,"Biography,Comedy,Documentary",7.7,85.0
14,"Oct 25, 2002",All or Nothing,9000000,184255,184255,368510,-8631490,-95.90544444444444,"Comedy,Romance",4.8,107.0
19,"May 8, 2015",Skin Trade,9000000,1242,1242,2484,-8997516,-99.9724,Documentary,8.8,78.0
19,"May 8, 2015",Skin Trade,9000000,1242,1242,2484,-8997516,-99.9724,"Action,Crime,Thriller",5.7,96.0
20,"Jun 17, 2014",Beneath Hill 60,9000000,0,3440939,3440939,-5559061,-61.76734444444445,"Drama,History,War",7.1,122.0
24,"May 18, 2012",Polisse,8900000,176988,22744132,22921120,14021120,157.54067415730339,"Crime,Drama",7.3,127.0
25,"Nov 13, 2015",Heist,8900000,50136,3324131,3374267,-5525733,-62.08688764044944,"Action,Crime,Thriller",6.1,93.0
25,"Nov 13, 2015",Heist,8900000,50136,3324131,3374267,-5525733,-62.08688764044944,Action,6.4,47.0
30,"Nov 18, 2016",Manchester by the Sea,8500000,47695371,77733867,125429238,116929238,1375.638094117647,Drama,7.8,137.0
34,"Oct 31, 2014",Nightcrawler,8500000,32381218,50334418,82715636,74215636,873.1251294117648,"Crime,Drama,Thriller",7.9,117.0
36,"Jan 16, 2019",Dragon Ball Super: Broly,8500000,30376755,122747755,153124510,144624510,1701.4648235294117,"Action,Adventure,Animation",8.0,100.0
38,"Sep 27, 2013",Baggage Claim,8500000,21569509,22885836,44455345,35955345,423.0040588235294,Comedy,5.1,96.0
39,"Oct 7, 2016",Middle School: The Worst Years of My Life,8500000,20007149,23311293,43318442,34818442,409.6287294117647,"Comedy,Family",6.1,92.0
47,"Jun 13, 2014",The Rover,8500000,1109199,3180252,4289451,-4210549,-49.53587058823529,"Action,Crime,Drama",6.4,103.0
50,"Dec 31, 2017",Posledniy bogatyr,8500000,0,30700192,30700192,22200192,261.1787294117647,"Action,Adventure,Comedy",6.6,114.0
51,"Nov 1, 2016",A.C.O.R.N.S.: Operation Crackdown,8500000,0,1353287,1353287,-7146713,-84.07897647058824,"Animation,Comedy,Family",3.9,83.0
54,"May 31, 2013",Yeh Jawaani Hai Deewani,8300000,3827466,50827466,54654932,46354932,558.493156626506,"Comedy,Drama,Musical",7.1,160.0
55,"Jun 4, 1999",Limbo,8300000,2160710,2598224,4758934,-3541066,-42.66344578313253,Drama,6.0,105.0
55,"Jun 4, 1999",Limbo,8300000,2160710,2598224,4758934,-3541066,-42.66344578313253,Drama,5.6,80.0
61,"Feb 17, 1984",Footloose,8200000,80000000,80000000,160000000,151800000,1851.219512195122,"Comedy,Drama,Music",5.9,113.0
63,"Jun 22, 1984",The Karate Kid,8000000,90815558,90815558,181631116,173631116,2170.38895,"Action,Drama,Family",6.2,140.0
67,"Sep 17, 2010",Easy A,8000000,58401464,76200721,134602185,126602185,1582.5273125,"Comedy,Drama,Romance",7.1,92.0
68,"Aug 8, 1986",Stand by Me,8000000,52287414,52287414,104574828,96574828,1207.18535,Drama,7.2,91.0
72,"May 3, 2019",The Intruder,8000000,35095904,36005871,71101775,63101775,788.7721875000001,Horror,4.3,106.0
72,"May 3, 2019",The Intruder,8000000,35095904,36005871,71101775,63101775,788.7721875000001,"Drama,Horror,Mystery",5.5,102.0
73,"Sep 30, 2011",50/50,8000000,35016118,41334735,76350853,68350853,854.3856625,"Comedy,Drama,Romance",7.7,100.0
73,"Sep 30, 2011",50/50,8000000,35016118,41334735,76350853,68350853,854.3856625,Documentary,7.5,77.0
75,"Sep 2, 2015",A Walk in the Woods,8000000,29499394,37119358,66618752,58618752,732.7344,"Adventure,Biography,Comedy",6.3,104.0
76,"Oct 11, 2002",Brown Sugar,8000000,27362712,28315272,55677984,47677984,595.9748000000001,Drama,4.0,120.0
78,"Jan 31, 2014",That Awkward Moment,8000000,26068955,53068955,79137910,71137910,889.223875,"Comedy,Romance",6.2,94.0
79,"Mar 21, 2008",Shutter,8000000,25928550,47782426,73710976,65710976,821.3872,Thriller,7.7,133.0
79,"Mar 21, 2008",Shutter,8000000,25928550,47782426,73710976,65710976,821.3872,"Drama,Family,Thriller",7.2,123.0
79,"Mar 21, 2008",Shutter,8000000,25928550,47782426,73710976,65710976,821.3872,"Horror,Thriller",5.3,106.0
82,"May 7, 1993",Much Ado About Nothing,8000000,22549338,22549338,45098676,37098676,463.73344999999995,"Comedy,Drama,Romance",4.5,68.0
82,"May 7, 1993",Much Ado About Nothing,8000000,22549338,22549338,45098676,37098676,463.73344999999995,"Comedy,Drama,Romance",7.2,109.0
82,"May 7, 1993",Much Ado About Nothing,8000000,22549338,22549338,45098676,37098676,463.73344999999995,"Comedy,Drama",7.7,167.0
82,"May 7, 1993",Much Ado About Nothing,8000000,22549338,22549338,45098676,37098676,463.73344999999995,Drama,6.6,94.0
82,"May 7, 1993",Much Ado About Nothing,8000000,22549338,22549338,45098676,37098676,463.73344999999995,"Comedy,Romance",8.4,161.0
88,"Sep 18, 2013",Enough Said,8000000,17550872,25621449,43172321,35172321,439.65401249999996,"Comedy,Drama,Romance",7.0,93.0
91,"Jun 27, 2014",Begin Again,8000000,16170632,68838736,85009368,77009368,962.6170999999999,"Drama,Family",7.0,68.0
91,"Jun 27, 2014",Begin Again,8000000,16170632,68838736,85009368,77009368,962.6170999999999,"Comedy,Drama,Music",7.4,104.0
93,"May 19, 2006",See No Evil,8000000,15032800,18828036,33860836,25860836,323.26045,Documentary,7.3,75.0
97,"Apr 29, 2011",Prom,8000000,10130219,10763183,20893402,12893402,161.167525,"Comedy,Drama,Family",5.4,104.0
100,"Jun 12, 2015",Me and Earl and the Dying Girl,8000000,6758416,9266180,16024596,8024596,100.30745,"Comedy,Drama,Romance",7.8,105.0
1,"Oct 8, 2010",It's Kind of a Funny Story,8000000,6363628,6632950,12996578,4996578,62.45722500000001,"Comedy,Drama,Romance",7.1,101.0
5,"Sep 2, 2016",Morgan,8000000,3915251,7298786,11214037,3214037,40.175462499999995,"Drama,Romance",6.8,89.0
5,"Sep 2, 2016",Morgan,8000000,3915251,7298786,11214037,3214037,40.175462499999995,"Action,Horror,Sci-Fi",5.8,92.0
6,"Dec 30, 2015",Anomalisa,8000000,3759286,5706168,9465454,1465454,18.318175,"Animation,Comedy,Drama",7.3,90.0
8,"Dec 29, 2010",Another Year,8000000,3205706,20005613,23211319,15211319,190.14148749999998,"Comedy,Drama",7.3,129.0
8,"Dec 29, 2010",Another Year,8000000,3205706,20005613,23211319,15211319,190.14148749999998,"Drama,Romance",6.6,107.0
8,"Dec 29, 2010",Another Year,8000000,3205706,20005613,23211319,15211319,190.14148749999998,Documentary,7.2,181.0
13,"Apr 6, 2018",Lean on Pete,8000000,1163056,2455027,3618083,-4381917,-54.773962499999996,"Adventure,Drama",7.2,121.0
14,"Nov 19, 2010",Made in Dagenham,8000000,1095369,15644196,16739565,8739565,109.24456250000001,"Biography,Comedy,Drama",7.2,113.0
16,"May 3, 2019",El Chicano,8000000,700261,700261,1400522,-6599478,-82.493475,Drama,5.7,108.0
24,"Oct 26, 2018",London Fields,8000000,252676,433732,686408,-7313592,-91.4199,"Crime,Mystery,Thriller",4.3,118.0
25,"Sep 16, 2011",Restless,8000000,163753,2772511,2936264,-5063736,-63.296699999999994,"Drama,Romance",6.8,91.0
25,"Sep 16, 2011",Restless,8000000,163753,2772511,2936264,-5063736,-63.296699999999994,Drama,8.4,53.0
28,"Oct 29, 2010",Wild Target,8000000,109338,5314194,5423532,-2576468,-32.205850000000005,"Action,Comedy,Crime",6.8,98.0
30,"Oct 5, 2012",Wuthering Heights,8000000,100915,2721534,2822449,-5177551,-64.7193875,"Drama,Romance",6.1,129.0
31,"Nov 18, 2016",A Street Cat Named Bob,8000000,82703,17382693,17465396,9465396,118.31745000000001,"Biography,Comedy,Drama",7.4,103.0
33,"May 22, 2015",Aloft,8000000,53086,237688,290774,-7709226,-96.365325,Drama,5.3,112.0
36,"Apr 27, 2001",Akira,8000000,19585,19585,39170,-7960830,-99.510375,"Drama,Romance",5.9,134.0
42,"Aug 12, 2014",Swelter,8000000,0,44197,44197,-7955803,-99.44753750000001,"Action,Crime,Drama",4.6,96.0
47,"May 6, 2016",Code of Honor,8000000,0,0,0,-8000000,-100.0,"Action,Crime,Thriller",4.2,106.0
48,"Jun 21, 2019",Burn Your Maps,8000000,0,0,0,-8000000,-100.0,Adventure,7.9,102.0
53,"Dec 13, 1989",Driving Miss Daisy,7500000,106593296,106593296,213186592,205686592,2742.487893333333,"Comedy,Drama",8.2,100.0
67,"Dec 21, 2011",Albert Nobbs,7500000,3014696,8539003,11553699,4053699,54.04932,"Drama,Romance",6.7,113.0
68,"Jun 24, 2016",The Neon Demon,7500000,1333124,3559803,4892927,-2607073,-34.76097333333333,"Horror,Thriller",6.2,117.0
74,"Jan 9, 2015",Black November,7500000,0,32572,32572,-7467428,-99.56570666666667,"Action,Crime,Drama",5.4,95.0
75,"Feb 24, 2015",Outside Bet,7500000,0,13524,13524,-7486476,-99.81968,Comedy,5.0,101.0
76,"May 15, 2015",Pound of Flesh,7500000,0,0,0,-7500000,-100.0,"Crime,Drama,Thriller",3.2,104.0
76,"May 15, 2015",Pound of Flesh,7500000,0,0,0,-7500000,-100.0,"Action,Thriller",5.2,104.0
76,"May 15, 2015",Pound of Flesh,7500000,0,0,0,-7500000,-100.0,Drama,7.5,145.0
77,"Jan 13, 2017",The Bye Bye Man,7400000,22395806,31187727,53583533,46183533,624.1017972972973,"Drama,Fantasy,Horror",4.3,96.0
85,"Sep 16, 2011",3,7200000,59774,295492,355266,-6844734,-95.06575000000001,"Comedy,Drama,Romance",6.7,119.0
85,"Sep 16, 2011",3,7200000,59774,295492,355266,-6844734,-95.06575000000001,"Drama,Mystery,Romance",7.2,145.0
85,"Sep 16, 2011",3,7200000,59774,295492,355266,-6844734,-95.06575000000001,"Comedy,Drama",6.1,115.0
85,"Sep 16, 2011",3,7200000,59774,295492,355266,-6844734,-95.06575000000001,"Horror,Mystery,Thriller",3.9,80.0
88,"Jun 29, 2012",Magic Mike,7000000,113721571,170549753,284271324,277271324,3961.0189142857143,"Comedy,Drama",6.1,110.0
90,"Mar 16, 2018",I Can Only Imagine,7000000,83482352,85604221,169086573,162086573,2315.5224714285714,"Biography,Drama,Family",7.4,110.0
91,"Mar 15, 2019",Five Feet Apart,7000000,45729221,80504421,126233642,119233642,1703.3377428571428,"Drama,Romance",7.2,116.0
93,"May 6, 2011",Jumping the Broom,7000000,37295394,38158601,75453995,68453995,977.9142142857144,"Comedy,Drama",5.7,112.0
100,"Mar 29, 1974",The Great Gatsby,7000000,26533200,26533200,53066400,46066400,658.0914285714287,"Drama,Romance",7.3,143.0
4,"Apr 7, 2017",Gifted,7000000,24801212,36964656,61765868,54765868,782.3695428571428,"Crime,Drama,Thriller",5.6,103.0
4,"Apr 7, 2017",Gifted,7000000,24801212,36964656,61765868,54765868,782.3695428571428,Drama,7.6,101.0
6,"Apr 11, 2001",Kingdom Come,7000000,23247539,23393939,46641478,39641478,566.3068285714286,"Documentary,Drama",7.6,87.0
6,"Apr 11, 2001",Kingdom Come,7000000,23247539,23393939,46641478,39641478,566.3068285714286,Horror,4.4,97.0
6,"Apr 11, 2001",Kingdom Come,7000000,23247539,23393939,46641478,39641478,566.3068285714286,"Drama,Thriller",8.3,75.0
8,"Feb 12, 1988",Action Jackson,7000000,20257000,20257000,40514000,33514000,478.77142857142854,"Action,Thriller",3.3,144.0
9,"May 13, 1983",Breathless,7000000,19910002,19910002,39820004,32820004,468.8572,"Comedy,Thriller",5.1,92.0
9,"May 13, 1983",Breathless,7000000,19910002,19910002,39820004,32820004,468.8572,Documentary,7.4,70.0
11,"Jun 19, 2015",Dope,7000000,17506470,18190831,35697301,28697301,409.9614428571429,"Comedy,Crime,Drama",7.2,103.0
14,"Jan 17, 2014",Devil's Due,7000000,15821461,36146087,51967548,44967548,642.3935428571428,"Horror,Mystery,Thriller",4.1,89.0
16,"Nov 14, 2014",Beyond the Lights,7000000,14618727,14618727,29237454,22237454,317.6779142857143,"Drama,Music,Romance",6.9,116.0
27,"Jun 18, 2010",Cyrus,7000000,7468936,10062896,17531832,10531832,150.45474285714286,"Crime,Horror,Mystery",4.7,87.0
27,"Jun 18, 2010",Cyrus,7000000,7468936,10062896,17531832,10531832,150.45474285714286,"Comedy,Drama,Romance",6.3,91.0
32,"May 1, 1992",Split Second,7000000,5430822,5430822,10861644,3861644,55.16634285714286,Drama,8.1,83.0
42,"Dec 22, 2010",Somewhere,7000000,1785645,17023121,18808766,11808766,168.69665714285716,"Comedy,Drama",6.3,97.0
43,"Jan 13, 2012",We Need to Talk About Kevin,7000000,1738692,10765283,12503975,5503975,78.62821428571428,"Drama,Mystery,Thriller",7.5,112.0
44,"Feb 2, 2007",Factory Girl,7000000,1661464,1661464,3322928,-3677072,-52.5296,"Drama,Romance",7.3,90.0
45,"Nov 15, 2013",The Christmas Candle,7000000,1632000,1933829,3565829,-3434171,-49.05958571428572,"Drama,Family",6.2,100.0
51,"Oct 2, 2015",Freeheld,7000000,546201,1732228,2278429,-4721571,-67.45101428571428,"Biography,Drama,Romance",6.5,103.0
52,"Apr 2, 2014",Dom Hemingway,7000000,523511,1857458,2380969,-4619031,-65.98615714285714,"Comedy,Crime,Drama",6.2,93.0
53,"Jul 30, 2010",The Extra Man,7000000,453377,492108,945485,-6054515,-86.49307142857143,Comedy,5.9,108.0
54,"May 13, 2011",Hesher,7000000,382946,382946,765892,-6234108,-89.05868571428572,"Comedy,Crime,Drama",7.0,106.0
56,"Feb 14, 2003",Gerry,7000000,254683,719699,974382,-6025618,-86.08025714285714,Biography,6.8,131.0
59,"Mar 26, 2010",Ca$h,7000000,46488,46488,92976,-6907024,-98.67177142857143,"Crime,Thriller",6.0,108.0
63,"Dec 6, 2016",Oddball,7000000,0,10237229,10237229,3237229,46.24612857142857,"Adventure,Family",6.4,95.0
63,"Dec 6, 2016",Oddball,7000000,0,10237229,10237229,3237229,46.24612857142857,Documentary,6.4,5.0
64,"Aug 18, 2015",Z Storm,7000000,0,2053330,2053330,-4946670,-70.66671428571428,"Action,Crime",5.4,92.0
66,"Jul 23, 2013",Twixt,7000000,0,1268346,1268346,-5731654,-81.88077142857144,"Comedy,Fantasy,Horror",4.8,88.0
67,"Nov 20, 2015",Criminal Activities,7000000,0,386744,386744,-6613256,-94.47508571428571,"Crime,Drama,Thriller",5.8,94.0
73,"Sep 21, 2012",House at the End of the Street,6900000,31611916,44103982,75715898,68815898,997.3318550724638,"Drama,Horror,Thriller",5.6,101.0
75,"Jan 31, 2017",Two Lovers and a Bear,6840000,0,22273,22273,-6817727,-99.67437134502924,"Adventure,Drama,Romance",6.1,96.0
76,"Sep 17, 2010",Incendies,6800000,6857096,16038343,22895439,16095439,236.69763235294118,"Drama,Mystery,War",8.3,131.0
84,"Oct 3, 2014",Annabelle,6500000,84273813,256862920,341136733,334636733,5148.257430769231,"Horror,Mystery,Thriller",5.4,99.0
90,"Apr 2, 1993",The Adventures of Huck Finn,6500000,24103594,24103594,48207188,41707188,641.6490461538461,"Adventure,Family",5.8,99.0
95,"Oct 20, 2017",Same Kind of Different as Me,6500000,6423605,6423605,12847210,6347210,97.64938461538462,"Biography,Drama",6.5,119.0
97,"Dec 2, 2011",Shame,6500000,4002293,20412841,24415134,17915134,275.6174461538461,Drama,7.2,101.0
97,"Dec 2, 2011",Shame,6500000,4002293,20412841,24415134,17915134,275.6174461538461,Drama,6.4,90.0
99,"May 31, 2013",The East,6500000,2274649,3027956,5302605,-1197395,-18.42146153846154,"Adventure,Drama,Thriller",6.8,116.0
1,"Nov 13, 2009",The Messenger,6500000,1109660,1744952,2854612,-3645388,-56.08289230769231,Drama,8.0,74.0
1,"Nov 13, 2009",The Messenger,6500000,1109660,1744952,2854612,-3645388,-56.08289230769231,"Drama,Mystery,Thriller",5.1,101.0
1,"Nov 13, 2009",The Messenger,6500000,1109660,1744952,2854612,-3645388,-56.08289230769231,"Documentary,Family",7.7,89.0
1,"Nov 13, 2009",The Messenger,6500000,1109660,1744952,2854612,-3645388,-56.08289230769231,"Drama,Thriller,War",5.8,100.0
3,"Aug 17, 2001",Aberdeen,6500000,64148,64148,128296,-6371704,-98.02621538461538,Family,6.2,97.0
4,"Dec 31, 2011",Tracker,6500000,0,3149,3149,-6496851,-99.95155384615386,"Action,Adventure,Drama",6.5,102.0
7,"Oct 10, 2007",Control,6400000,871577,8902141,9773718,3373718,52.714343750000005,"Action,Crime,Drama",6.4,127.0
7,"Oct 10, 2007",Control,6400000,871577,8902141,9773718,3373718,52.714343750000005,"Crime,Mystery,Sci-Fi",6.3,90.0
18,"Sep 19, 1980",Ordinary People,6000000,52302978,52302978,104605956,98605956,1643.4325999999999,Drama,7.4,107.0
19,"May 11, 2018",Breaking In,6000000,46840590,51411620,98252210,92252210,1537.5368333333333,"Action,Crime,Drama",5.4,88.0
33,"Mar 29, 2019",Unplanned,6000000,18107621,18107621,36215242,30215242,503.58736666666664,"Biography,Drama",6.3,106.0
36,"Feb 8, 2019",The Prodigy,6000000,14856291,19789712,34646003,28646003,477.4333833333333,"Horror,Thriller",5.9,92.0
37,"Nov 30, 2018",The Possession of Hannah Grace,6000000,14836174,42785387,57621561,51621561,860.3593500000001,"Horror,Mystery,Thriller",5.2,86.0
46,"Sep 7, 2012",The Words,6000000,11494838,16369708,27864546,21864546,364.4091,"Drama,Mystery,Romance",7.1,102.0
47,"Jan 15, 2016",The Lady in the Van,6000000,10021175,42320503,52341678,46341678,772.3613,"Biography,Comedy,Drama",6.7,104.0
48,"Apr 27, 2012",Bernie,6000000,9204489,10106975,19311464,13311464,221.85773333333333,"Biography,Comedy,Crime",6.8,99.0
53,"Mar 16, 2012",Casa de mi Padre,6000000,5909483,8446952,14356435,8356435,139.27391666666665,"Comedy,Western",5.5,84.0
54,"Jul 29, 2011",The Guard,6000000,5359774,21197454,26557228,20557228,342.62046666666663,"Comedy,Crime,Thriller",7.3,96.0
61,"Jul 18, 2014",Wish I Was Here,6000000,3591299,6591365,10182664,4182664,69.71106666666667,"Comedy,Drama",6.7,106.0
62,"Dec 21, 2006",Venus,6000000,3347411,7818479,11165890,5165890,86.09816666666667,Documentary,7.0,80.0
62,"Dec 21, 2006",Venus,6000000,3347411,7818479,11165890,5165890,86.09816666666667,"Comedy,Drama,Family",5.9,95.0
63,"Mar 14, 2014",Veronica Mars,6000000,3322127,3485383,6807510,807510,13.4585,"Crime,Drama,Mystery",6.8,107.0
70,"Jul 15, 2011",Snow Flower and the Secret Fan,6000000,1348205,11348205,12696410,6696410,111.60683333333334,"Drama,History",6.1,104.0
71,"Sep 14, 2018",Mandy,6000000,1214525,1427656,2642181,-3357819,-55.96365,"Drama,Thriller",4.1,113.0
71,"Sep 14, 2018",Mandy,6000000,1214525,1427656,2642181,-3357819,-55.96365,"Action,Fantasy,Horror",6.6,121.0
76,"Mar 25, 2011",The 5th Quarter,6000000,408159,408159,816318,-5183682,-86.3947,"Biography,Drama,Sport",5.7,90.0
83,"Dec 7, 2012",Deadfall,6000000,66351,1673635,1739986,-4260014,-71.00023333333333,"Crime,Drama,Thriller",6.3,95.0
84,"May 8, 2009",Julia,6000000,65108,1365108,1430216,-4569784,-76.16306666666667,"Horror,Thriller",4.6,95.0
84,"May 8, 2009",Julia,6000000,65108,1365108,1430216,-4569784,-76.16306666666667,Documentary,7.2,89.0
87,"Jan 23, 2015",Song One,6000000,32251,437089,469340,-5530660,-92.17766666666667,"Drama,Music",5.8,86.0
91,"Feb 9, 2010",Icarus,6000000,0,0,0,-6000000,-100.0,"Documentary,Sport,Thriller",7.9,120.0
94,"Dec 31, 2011",Freaky Deaky,6000000,0,0,0,-6000000,-100.0,"Comedy,Crime,Thriller",6.1,90.0
95,"May 10, 2011",The Hit List,6000000,0,0,0,-6000000,-100.0,"Action,Thriller",5.4,90.0
97,"Aug 2, 1996",Emma,5900000,22231658,37831658,60063316,54163316,918.0223050847458,Thriller,4.7,70.0
97,"Aug 2, 1996",Emma,5900000,22231658,37831658,60063316,54163316,918.0223050847458,Drama,5.0,77.0
3,"Oct 5, 2012",Trade of Innocents,5800000,15091,15091,30182,-5769818,-99.47962068965516,"Drama,Thriller",5.4,88.0
11,"Jul 16, 2010",Standing Ovation,5600000,531806,531806,1063612,-4536388,-81.00692857142857,Musical,3.3,105.0
12,"Dec 7, 2012",Khiladi 786,5600000,385422,14683763,15069185,9469185,169.0925892857143,"Action,Comedy",4.4,141.0
17,"Nov 22, 1996",Shine,5500000,35811509,36672493,72484002,66984002,1217.8909454545455,"Drama,Music",4.9,95.0
18,"Sep 27, 2013",Don Jon,5500000,24477704,41268579,65746283,60246283,1095.3869636363636,"Comedy,Drama,Romance",6.6,90.0
20,"Sep 28, 2018",Hell Fest,5500000,11107431,18119231,29226662,23726662,431.3938545454546,Horror,5.5,89.0
23,"Dec 14, 2001",Iris,5500000,5580479,5580479,11160958,5660958,102.92650909090911,"Drama,Family,History",5.8,85.0
23,"Dec 14, 2001",Iris,5500000,5580479,5580479,11160958,5660958,102.92650909090911,"Biography,Documentary,History",7.1,79.0
26,"Oct 3, 2003",Wonderland,5500000,1060512,1060512,2121024,-3378976,-61.43592727272728,"Fantasy,Horror,Sci-Fi",5.0,80.0
26,"Oct 3, 2003",Wonderland,5500000,1060512,1060512,2121024,-3378976,-61.43592727272728,Drama,6.1,99.0
26,"Oct 3, 2003",Wonderland,5500000,1060512,1060512,2121024,-3378976,-61.43592727272728,Comedy,3.9,80.0
26,"Oct 3, 2003",Wonderland,5500000,1060512,1060512,2121024,-3378976,-61.43592727272728,"Comedy,Drama",6.1,92.0
29,"Oct 21, 2011",Le Havre,5500000,611709,13480196,14091905,8591905,156.21645454545455,"Comedy,Drama",7.2,93.0
31,"Jul 15, 2011",Salvation Boulevard,5500000,28468,28468,56936,-5443064,-98.9648,"Action,Comedy,Drama",5.3,96.0
32,"Jan 23, 2015",R100,5500000,24956,24956,49912,-5450088,-99.09250909090909,"Comedy,Drama",6.1,99.0
33,"May 5, 2015",Miss Julie,5500000,0,863895,863895,-4636105,-84.29281818181819,"Drama,Romance",4.1,85.0
33,"May 5, 2015",Miss Julie,5500000,0,863895,863895,-4636105,-84.29281818181819,"Drama,Romance",5.5,129.0
34,"Dec 31, 2008",Animals,5500000,0,0,0,-5500000,-100.0,"Drama,Fantasy",6.2,94.0
34,"Dec 31, 2008",Animals,5500000,0,0,0,-5500000,-100.0,Drama,6.3,90.0
34,"Dec 31, 2008",Animals,5500000,0,0,0,-5500000,-100.0,"Comedy,Drama",7.3,109.0
38,"Jul 19, 2013",Grabbers,5300000,0,440821,440821,-4859179,-91.68262264150944,"Comedy,Horror,Sci-Fi",6.3,94.0
44,"Aug 1, 1944",Wilson,5200000,2000000,2000000,4000000,-1200000,-23.076923076923077,"Comedy,Drama",5.8,94.0
44,"Aug 1, 1944",Wilson,5200000,2000000,2000000,4000000,-1200000,-23.076923076923077,Documentary,7.1,104.0
46,"Apr 22, 2011",Dum Maaro Dum,5200000,564489,11633427,12197916,6997916,134.5753076923077,"Action,Crime,Drama",6.2,128.0
49,"Feb 24, 2017",Get Out,5000000,176040665,255367951,431408616,426408616,8528.17232,"Horror,Mystery,Thriller",7.7,104.0
50,"Jan 20, 2017",Split,5000000,138141585,278964806,417106391,412106391,8242.12782,"Comedy,Romance,Sport",2.9,90.0
50,"Jan 20, 2017",Split,5000000,138141585,278964806,417106391,412106391,8242.12782,"Drama,Fantasy",3.6,127.0
50,"Jan 20, 2017",Split,5000000,138141585,278964806,417106391,412106391,8242.12782,"Horror,Thriller",7.3,117.0
50,"Jan 20, 2017",Split,5000000,138141585,278964806,417106391,412106391,8242.12782,Drama,7.0,80.0
50,"Jan 20, 2017",Split,5000000,138141585,278964806,417106391,412106391,8242.12782,"Action,Drama,Sport",5.4,123.0
51,"Oct 21, 2011",Paranormal Activity 3,5000000,104028807,207039844,311068651,306068651,6121.37302,"Horror,Mystery,Thriller",5.8,83.0
54,"Mar 11, 2016",10 Cloverfield Lane,5000000,72082999,108286422,180369421,175369421,3507.38842,"Drama,Horror,Mystery",7.2,103.0
55,"Jul 22, 2016",Lights Out,5000000,67268835,148806510,216075345,211075345,4221.5069,"Drama,Mystery,Thriller",6.4,87.0
55,"Jul 22, 2016",Lights Out,5000000,67268835,148806510,216075345,211075345,4221.5069,"Drama,Horror,Mystery",6.3,81.0
56,"Sep 11, 2015",The Visit,5000000,65206105,98677816,163883921,158883921,3177.67842,"Comedy,Drama,Romance",8.3,90.0
56,"Sep 11, 2015",The Visit,5000000,65206105,98677816,163883921,158883921,3177.67842,"Horror,Mystery,Thriller",6.2,94.0
58,"Oct 13, 2017",Happy Death Day,5000000,55683845,125010260,180694105,175694105,3513.8821,"Horror,Mystery,Thriller",6.5,96.0
59,"Oct 19, 2012",Paranormal Activity 4,5000000,53900335,142817992,196718327,191718327,3834.36654,"Horror,Mystery,Thriller",4.6,88.0
60,"Oct 24, 2014",Ouija,5000000,50856010,103300632,154156642,149156642,2983.13284,"Horror,Mystery,Thriller",4.5,89.0
63,"Aug 7, 2015",The Gift,5000000,43787265,58978477,102765742,97765742,1955.3148400000002,"Action,Drama,Thriller",7.5,113.0
63,"Aug 7, 2015",The Gift,5000000,43787265,58978477,102765742,97765742,1955.3148400000002,"Drama,Mystery,Thriller",7.1,108.0
63,"Aug 7, 2015",The Gift,5000000,43787265,58978477,102765742,97765742,1955.3148400000002,Drama,6.0,82.0
63,"Aug 7, 2015",The Gift,5000000,43787265,58978477,102765742,97765742,1955.3148400000002,Documentary,6.2,56.0
63,"Aug 7, 2015",The Gift,5000000,43787265,58978477,102765742,97765742,1955.3148400000002,Drama,8.0,118.0
64,"Jun 23, 2017",The Big Sick,5000000,42872467,53972860,96845327,91845327,1836.90654,"Comedy,Drama,Romance",7.6,120.0
69,"Dec 24, 2003",Monster,5000000,34469210,64240813,98710023,93710023,1874.20046,"Action,Adventure,Comedy",4.8,85.0
69,"Dec 24, 2003",Monster,5000000,34469210,64240813,98710023,93710023,1874.20046,"Action,Drama,Thriller",6.5,113.0
69,"Dec 24, 2003",Monster,5000000,34469210,64240813,98710023,93710023,1874.20046,Horror,7.2,90.0
69,"Dec 24, 2003",Monster,5000000,34469210,64240813,98710023,93710023,1874.20046,"Comedy,Drama,Family",7.5,139.0
70,"Jan 3, 2014",Paranormal Activity: The Marked Ones,5000000,32462372,90904854,123367226,118367226,2367.34452,"Horror,Mystery,Thriller",5.0,84.0
72,"Apr 11, 2014",Oculus,5000000,27695246,44115496,71810742,66810742,1336.21484,"Horror,Mystery",6.5,104.0
73,"Nov 1, 2013",Dallas Buyers Club,5000000,27298285,60611845,87910130,82910130,1658.2025999999998,"Biography,Drama",8.0,117.0
74,"Aug 26, 2015",No Escape,5000000,27288872,42844516,70133388,65133388,1302.6677599999998,"Action,Thriller",6.8,103.0
76,"Feb 27, 2015",The Lazarus Effect,5000000,25801570,38359310,64160880,59160880,1183.2176,"Horror,Mystery,Sci-Fi",5.2,83.0
78,"Aug 26, 2011",Our Idiot Brother,5000000,24814830,25861249,50676079,45676079,913.52158,"Comedy,Drama",6.4,90.0
79,"Mar 9, 2018",The Strangers: Prey at Night,5000000,24431472,29960051,54391523,49391523,987.83046,Horror,5.2,85.0
82,"Oct 13, 2000",Billy Elliot,5000000,21995263,109253745,131249008,126249008,2524.98016,"Comedy,Drama,Music",8.5,169.0
83,"Jul 5, 2013",The Way Way Back,5000000,21502690,26853810,48356500,43356500,867.13,"Comedy,Drama",7.4,103.0
84,"Aug 29, 2014","As Above, So Below",5000000,21222315,41824066,63046381,58046381,1160.92762,"Adventure,Horror,Mystery",6.2,93.0
86,"Dec 17, 1997",The Apostle,5000000,20733485,21277770,42011255,37011255,740.2251,"Animation,Horror",7.0,80.0
86,"Dec 17, 1997",The Apostle,5000000,20733485,21277770,42011255,37011255,740.2251,Drama,7.4,117.0
90,"Feb 19, 2016",Race,5000000,19115191,23745772,42860963,37860963,757.21926,Drama,3.9,150.0
90,"Feb 19, 2016",Race,5000000,19115191,23745772,42860963,37860963,757.21926,"Biography,Drama,Sport",7.1,134.0
92,"Jan 16, 2015",Still Alice,5000000,18656400,41699612,60356012,55356012,1107.12024,Drama,7.5,101.0
94,"Sep 2, 2011",Apollo 18,5000000,17686929,26517819,44204748,39204748,784.09496,"Horror,Mystery,Sci-Fi",5.2,86.0
95,"Mar 23, 2018","Paul, Apostle of Christ",5000000,17547999,25529498,43077497,38077497,761.54994,"Adventure,Biography,Drama",6.7,108.0
96,"Oct 10, 2014",Addicted,5000000,17390770,17499242,34890012,29890012,597.80024,"Drama,Thriller",5.2,106.0
3,"Mar 15, 2013",Spring Breakers,5000000,14124286,31149251,45273537,40273537,805.47074,"Comedy,Crime,Drama",5.3,94.0
4,"Jun 9, 2017",It Comes at Night,5000000,13985117,19720203,33705320,28705320,574.1064,"Horror,Mystery",6.2,91.0
12,"Mar 3, 2017",Before I Fall,5000000,12241072,18945682,31186754,26186754,523.7350799999999,"Drama,Fantasy,Mystery",6.4,98.0
15,"Jan 29, 2016",Fifty Shades of Black,5000000,11686940,22113075,33800015,28800015,576.0003,Comedy,3.5,92.0
21,"Mar 17, 2017",The Belko Experiment,5000000,10166820,11792942,21959762,16959762,339.19524,"Horror,Thriller",6.1,89.0
22,"Mar 11, 2016",The Perfect Match,5000000,9669521,10182050,19851571,14851571,297.03141999999997,"Comedy,Romance",4.9,96.0
28,"Apr 27, 2001",The Forsaken,5000000,6755271,6755271,13510542,8510542,170.21084,"Drama,Horror,Thriller",6.3,86.0
29,"Sep 21, 2018",Fahrenheit 11/9,5000000,6352306,6653715,13006021,8006021,160.12042,Documentary,6.7,128.0
31,"May 28, 2010",Sea Rex 3D: Journey to a Prehistoric World,5000000,6096582,16515203,22611785,17611785,352.2357,Documentary,6.9,41.0
38,"Sep 11, 2015",90 Minutes in Heaven,5000000,4816142,4816142,9632284,4632284,92.64568,Drama,4.8,121.0
39,"Dec 2, 2016",Incarnate,5000000,4799774,9371036,14170810,9170810,183.4162,"Horror,Thriller",5.3,91.0
45,"Mar 3, 2017",Table 19,5000000,3614896,4620399,8235295,3235295,64.7059,"Comedy,Drama,Romance",5.8,87.0
46,"Apr 15, 2016",Green Room,5000000,3220371,3807503,7027874,2027874,40.55748,"Horror,Music,Thriller",7.0,95.0
47,"Mar 9, 2018",Thoroughbreds,5000000,3072605,3187302,6259907,1259907,25.198140000000002,"Comedy,Crime,Drama",6.7,92.0
49,"Mar 4, 2016",The Other Side of the Door,5000000,3000342,12905107,15905449,10905449,218.10898,Drama,3.8,90.0
49,"Mar 4, 2016",The Other Side of the Door,5000000,3000342,12905107,15905449,10905449,218.10898,Horror,5.3,96.0
50,"May 13, 2011",Everything Must Go,5000000,2712131,2821010,5533141,533141,10.66282,"Comedy,Drama",6.4,97.0
51,"Oct 10, 2014",Kill the Messenger,5000000,2450846,6656705,9107551,4107551,82.15102,"Biography,Crime,Drama",7.0,112.0
52,"Dec 17, 2010",Rabbit Hole,5000000,2229058,6205034,8434092,3434092,68.68184000000001,Drama,7.0,91.0
53,"Oct 23, 2015",Jem and the Holograms,5000000,2184640,2368937,4553577,-446423,-8.928460000000001,"Adventure,Drama,Family",4.1,118.0
54,"Dec 28, 2016",Paterson,5000000,2141423,10727536,12868959,7868959,157.37918,"Comedy,Drama,Romance",7.4,118.0
60,"Sep 12, 2014",Atlas Shrugged: Who Is John Galt?,5000000,851690,851690,1703380,-3296620,-65.9324,"Drama,Mystery,Sci-Fi",4.4,99.0
64,"Aug 16, 2013",Ain't Them Bodies Saints,5000000,391611,1075009,1466620,-3533380,-70.6676,"Crime,Drama,Romance",6.4,96.0
71,"Aug 7, 2015",Cop Car,5000000,134552,143658,278210,-4721790,-94.4358,"Crime,Thriller",6.3,88.0
76,"May 30, 2008",Stuck,5000000,67505,67505,135010,-4864990,-97.2998,Documentary,7.4,90.0
76,"May 30, 2008",Stuck,5000000,67505,67505,135010,-4864990,-97.2998,"Drama,Musical",6.2,90.0
76,"May 30, 2008",Stuck,5000000,67505,67505,135010,-4864990,-97.2998,"Comedy,Drama",8.8,85.0
76,"May 30, 2008",Stuck,5000000,67505,67505,135010,-4864990,-97.2998,Comedy,6.6,100.0
78,"Oct 17, 2014",Rudderless,5000000,56001,567219,623220,-4376780,-87.5356,"Comedy,Drama,Music",7.5,105.0
80,"Aug 14, 2009",Grace,5000000,8297,8297,16594,-4983406,-99.66812,"Crime,Drama,Horror",6.5,98.0
80,"Aug 14, 2009",Grace,5000000,8297,8297,16594,-4983406,-99.66812,Drama,6.0,95.0
80,"Aug 14, 2009",Grace,5000000,8297,8297,16594,-4983406,-99.66812,"Comedy,Crime,Romance",7.3,90.0
81,"May 15, 2015",Area 51,5000000,7556,7556,15112,-4984888,-99.69776,"Horror,Sci-Fi,Thriller",4.2,91.0
84,"Dec 31, 2008",The Cottage,5000000,0,1504960,1504960,-3495040,-69.90079999999999,"Drama,Horror,Thriller",4.8,88.0
85,"Dec 5, 2014",Dying of the Light,5000000,0,74639,74639,-4925361,-98.50721999999999,"Drama,Thriller",4.4,94.0
86,"Sep 2, 2016",Yoga Hosers,5000000,0,22958,22958,-4977042,-99.54084,"Action,Comedy,Fantasy",4.3,88.0
90,"Nov 21, 2014",Reach Me,5000000,0,0,0,-5000000,-100.0,"Comedy,Crime,Drama",4.9,95.0
91,"Aug 18, 2014",Henry & Me,5000000,0,0,0,-5000000,-100.0,"Animation,Family",6.2,67.0
92,"Jan 27, 2015",Born of War,5000000,0,0,0,-5000000,-100.0,"Action,Drama,Thriller",4.4,109.0
93,"Jan 9, 2015",Let's Kill Ward's Wife,5000000,0,0,0,-5000000,-100.0,"Comedy,Crime",5.4,82.0
99,"Mar 15, 2016",The Hatching,5000000,0,0,0,-5000000,-100.0,"Action,Adventure,Comedy",4.0,90.0
100,"Oct 27, 2015",Running Forever,5000000,0,0,0,-5000000,-100.0,Family,5.8,88.0
1,"Jan 23, 2015",Mommy,4900000,3498695,17536004,21034699,16134699,329.27957142857144,Drama,8.1,139.0
4,"Aug 17, 2012",The Awakening,4900000,95933,6924321,7020254,2120254,43.270489795918365,"Horror,Thriller",2.4,83.0
4,"Aug 17, 2012",The Awakening,4900000,95933,6924321,7020254,2120254,43.270489795918365,"Horror,Thriller",6.5,102.0
7,"Jan 6, 2006",Hostel,4800000,47326473,82241110,129567583,124767583,2599.3246458333333,"Action,Crime,Drama",5.1,111.0
7,"Jan 6, 2006",Hostel,4800000,47326473,82241110,129567583,124767583,2599.3246458333333,Drama,6.4,135.0
8,"Jul 19, 2013",Only God Forgives,4800000,775849,4494560,5270409,470409,9.8001875,"Crime,Drama",5.7,90.0
9,"Sep 30, 2011",Take Shelter,4750000,1728953,4972016,6700969,1950969,41.073031578947365,"Drama,Horror,Thriller",7.4,121.0
14,"Dec 31, 2011",Without Men,4700000,0,0,0,-4700000,-100.0,Comedy,3.3,87.0
15,"Mar 10, 2015",Treading Water,4700000,0,0,0,-4700000,-100.0,"Comedy,Drama",6.2,92.0
18,"Sep 14, 2012",Barfi,4600000,2804874,36751984,39556858,34956858,759.9316956521739,"Comedy,Romance",6.5,105.0
23,"Oct 19, 2007",Out of the Blue,4600000,728,731767,732495,-3867505,-84.07619565217391,"Comedy,Drama",6.2,108.0
31,"Jun 27, 1956",Moby Dick,4500000,10400000,10400000,20800000,16300000,362.22222222222223,Action,6.4,112.0
32,"Mar 25, 2016",The Lobster,4500000,9196278,18019834,27216112,22716112,504.80248888888883,"Comedy,Drama,Romance",7.1,119.0
33,"Oct 4, 1996",Bound,4500000,3802260,7011317,10813577,6313577,140.3017111111111,"Drama,Thriller",3.5,91.0
46,"Oct 7, 2011",Blackthorn,4500000,200558,1217307,1417865,-3082135,-68.49188888888888,"Action,Adventure,Western",6.6,102.0
47,"May 8, 2015",Maggie,4500000,187112,1027760,1214872,-3285128,-73.00284444444445,"Drama,Horror",5.6,95.0
47,"May 8, 2015",Maggie,4500000,187112,1027760,1214872,-3285128,-73.00284444444445,Drama,6.4,88.0
53,"Mar 1, 2013",The Sweeney,4500000,26345,8000366,8026711,3526711,78.37135555555555,"Action,Crime,Drama",6.1,112.0
54,"Sep 4, 2014",Falcon Rising,4500000,11774,11774,23548,-4476452,-99.47671111111111,"Action,Adventure",5.8,103.0
55,"Jun 25, 2013",Hansel & Gretel Get Baked,4500000,0,0,0,-4500000,-100.0,"Comedy,Horror",4.3,86.0
56,"Nov 7, 2014",Fugly,4500000,0,0,0,-4500000,-100.0,"Drama,Thriller",4.7,134.0
57,"Aug 28, 2015",Zipper,4500000,0,0,0,-4500000,-100.0,"Drama,Thriller",5.8,112.0
58,"Nov 3, 2015",The Final Girls,4500000,0,0,0,-4500000,-100.0,"Comedy,Drama,Fantasy",6.6,88.0
58,"Nov 3, 2015",The Final Girls,4500000,0,0,0,-4500000,-100.0,"Comedy,Horror",5.4,45.0
59,"Dec 1, 2017",Daisy Winters,4500000,0,0,0,-4500000,-100.0,Drama,6.8,90.0
64,"Jun 6, 2014",Anna,4357373,0,1200000,1200000,-3157373,-72.46047102233388,"Drama,Mystery,Sci-Fi",6.5,99.0
64,"Jun 6, 2014",Anna,4357373,0,1200000,1200000,-3157373,-72.46047102233388,Drama,6.8,96.0
64,"Jun 6, 2014",Anna,4357373,0,1200000,1200000,-3157373,-72.46047102233388,"Crime,Drama,Thriller",5.6,109.0
64,"Jun 6, 2014",Anna,4357373,0,1200000,1200000,-3157373,-72.46047102233388,Drama,6.3,110.0
64,"Jun 6, 2014",Anna,4357373,0,1200000,1200000,-3157373,-72.46047102233388,Biography,5.0,142.0
64,"Jun 6, 2014",Anna,4357373,0,1200000,1200000,-3157373,-72.46047102233388,Horror,2.4,97.0
69,"Oct 19, 1990",Night of the Living Dead,4200000,5835247,5835247,11670494,7470494,177.86890476190476,Horror,5.3,79.0
71,"Aug 13, 2010",Animal Kingdom,4200000,1044039,8078683,9122722,4922722,117.20766666666667,"Crime,Drama",7.3,113.0
73,"Oct 21, 2011",Cargo,4200000,0,313230,313230,-3886770,-92.54214285714286,Drama,5.2,85.0
73,"Oct 21, 2011",Cargo,4200000,0,313230,313230,-3886770,-92.54214285714286,"Drama,Horror,Sci-Fi",6.3,105.0
73,"Oct 21, 2011",Cargo,4200000,0,313230,313230,-3886770,-92.54214285714286,Drama,7.9,112.0
73,"Oct 21, 2011",Cargo,4200000,0,313230,313230,-3886770,-92.54214285714286,Drama,6.4,91.0
81,"Jan 23, 2015",The Boy Next Door,4000000,36006065,53401938,89408003,85408003,2135.2000749999997,"Horror,Thriller",4.7,91.0
85,"Jul 11, 2014",Boyhood,4000000,25379975,57273049,82653024,78653024,1966.3256000000001,Drama,7.9,165.0
86,"Dec 15, 1960",Exodus,4000000,21750000,21750000,43500000,39500000,987.5,Documentary,7.2,105.0
86,"Dec 15, 1960",Exodus,4000000,21750000,21750000,43500000,39500000,987.5,Sci-Fi,7.0,74.0
87,"Jul 9, 2010",The Kids Are All Right,4000000,20811365,36275469,57086834,53086834,1327.17085,"Comedy,Drama,Romance",7.0,106.0
89,"Apr 18, 2014",A Haunted House 2,4000000,17329487,21206861,38536348,34536348,863.4087,"Comedy,Fantasy",4.7,86.0
90,"Mar 1, 2013",The Last Exorcism Part II,4000000,15179303,25448707,40628010,36628010,915.7002500000001,"Drama,Horror,Thriller",4.0,88.0
95,"Aug 4, 2000",Saving Grace,4000000,12178602,27786849,39965451,35965451,899.1362750000001,"Crime,Drama,Horror",5.6,85.0
98,"May 13, 2016",The Darkness,4000000,10753574,10898293,21651867,17651867,441.296675,"Horror,Thriller",4.4,92.0
98,"May 13, 2016",The Darkness,4000000,10753574,10898293,21651867,17651867,441.296675,Thriller,5.7,92.0
2,"Apr 11, 2008",The Visitor,4000000,9427026,19174817,28601843,24601843,615.046075,"Drama,Romance",5.1,70.0
2,"Apr 11, 2008",The Visitor,4000000,9427026,19174817,28601843,24601843,615.046075,"Adventure,Documentary,Drama",6.0,74.0
2,"Apr 11, 2008",The Visitor,4000000,9427026,19174817,28601843,24601843,615.046075,"Drama,Family,Mystery",4.6,127.0
2,"Apr 11, 2008",The Visitor,4000000,9427026,19174817,28601843,24601843,615.046075,"Drama,Horror,Thriller",6.7,119.0
8,"May 25, 2007",Bug,4000000,7006708,8302995,15309703,11309703,282.74257500000004,"Drama,Mystery,Thriller",4.6,95.0
18,"Aug 24, 2012",Samsara,4000000,2672413,5966671,8639084,4639084,115.97710000000001,"Documentary,Music",8.5,102.0
20,"Jun 17, 2011",The Art of Getting By,4000000,1430241,1989035,3419276,-580724,-14.5181,"Drama,Romance",6.6,83.0
22,"Sep 23, 2011",Red State,4000000,1065429,1983596,3049025,-950975,-23.774375,"Action,Crime,Horror",6.2,88.0
25,"Oct 17, 2012",Holy Motors,4000000,641054,4230426,4871480,871480,21.787,"Drama,Fantasy",7.1,115.0
26,"Jun 13, 2014",The Signal,4000000,600896,2665322,3266218,-733782,-18.34455,"Drama,Mystery,Sci-Fi",6.1,97.0
29,"Mar 7, 2014",The Face of Love,4000000,385069,1158877,1543946,-2456054,-61.40135,"Drama,Mystery,Romance",6.2,92.0
30,"Apr 11, 2014",Joe,4000000,373375,373375,746750,-3253250,-81.33125,"Crime,Drama",6.9,117.0
35,"Jun 7, 2019",Late Night,4000000,246305,246305,492610,-3507390,-87.68475,"Comedy,Drama",5.9,102.0
38,"Apr 10, 2015",Desert Dancer,4000000,155271,596335,751606,-3248394,-81.20984999999999,"Biography,Drama,Music",6.2,104.0
41,"Jun 19, 2015",Manglehorn,4000000,132270,797439,929709,-3070291,-76.757275,Drama,5.6,97.0
43,"Apr 1, 2011",Trust,4000000,120016,120016,240032,-3759968,-93.9992,"Crime,Drama,Thriller",6.9,106.0
43,"Apr 1, 2011",Trust,4000000,120016,120016,240032,-3759968,-93.9992,Drama,7.3,92.0
43,"Apr 1, 2011",Trust,4000000,120016,120016,240032,-3759968,-93.9992,"Crime,Drama",6.4,100.0
47,"Apr 22, 2011",Stake Land,4000000,33245,679482,712727,-3287273,-82.181825,"Drama,Horror,Sci-Fi",6.5,98.0
49,"Dec 27, 2002",Sonny,4000000,17639,17639,35278,-3964722,-99.11805,Drama,6.3,90.0
51,"Apr 18, 2014",13 Sins,4000000,9134,47552,56686,-3943314,-98.58285,"Horror,Thriller",6.3,93.0
52,"Nov 18, 2011",Another Happy Day,4000000,9120,978527,987647,-3012353,-75.308825,"Comedy,Drama",6.0,119.0
53,"Feb 22, 2013",Inescapable,4000000,4327,4327,8654,-3991346,-99.78365,"Action,Drama,Mystery",5.2,93.0
56,"Mar 20, 2012",A Lonely Place to Die,4000000,0,442550,442550,-3557450,-88.93625,"Adventure,Crime,Thriller",6.3,99.0
57,"Dec 31, 2003",Nothing,4000000,0,63180,63180,-3936820,-98.4205,"Comedy,Drama",7.0,84.0
57,"Dec 31, 2003",Nothing,4000000,0,63180,63180,-3936820,-98.4205,Drama,7.4,46.0
62,"Nov 9, 2012",Replicas,4000000,0,0,0,-4000000,-100.0,"Drama,Sci-Fi,Thriller",5.4,107.0
64,"Dec 31, 2015",The Veil,4000000,0,0,0,-4000000,-100.0,"Action,Adventure,Sci-Fi",3.5,93.0
64,"Dec 31, 2015",The Veil,4000000,0,0,0,-4000000,-100.0,Horror,4.8,93.0
65,"Jul 11, 2014",The Perfect Wave,4000000,0,0,0,-4000000,-100.0,"Adventure,Biography,Drama",4.8,94.0
67,"Sep 8, 2015",Chain of Command,4000000,0,0,0,-4000000,-100.0,"Action,Thriller",3.5,88.0
79,"Nov 5, 2010",Four Lions,3750000,310007,2436111,2746118,-1003882,-26.770186666666667,"Comedy,Crime,Drama",7.3,97.0
84,"Nov 3, 2006",Unknown,3700000,26403,3355048,3381451,-318549,-8.609432432432433,"Action,Mystery,Thriller",6.9,113.0
84,"Nov 3, 2006",Unknown,3700000,26403,3355048,3381451,-318549,-8.609432432432433,Drama,6.9,96.0
91,"Apr 13, 2018",Truth or Dare,3500000,41411015,95127344,136538359,133038359,3801.095971428571,"Horror,Romance,Thriller",6.0,85.0
91,"Apr 13, 2018",Truth or Dare,3500000,41411015,95127344,136538359,133038359,3801.095971428571,"Comedy,Romance",5.0,100.0
91,"Apr 13, 2018",Truth or Dare,3500000,41411015,95127344,136538359,133038359,3801.095971428571,"Horror,Thriller",4.8,84.0
91,"Apr 13, 2018",Truth or Dare,3500000,41411015,95127344,136538359,133038359,3801.095971428571,"Drama,Romance",6.8,90.0
91,"Apr 13, 2018",Truth or Dare,3500000,41411015,95127344,136538359,133038359,3801.095971428571,"Horror,Thriller",5.2,100.0
93,"Apr 26, 1995",Friday,3500000,27467564,27936778,55404342,51904342,1482.9812,Family,5.9,117.0
94,"Feb 19, 2016",The Witch,3500000,25138705,40454520,65593225,62093225,1774.092142857143,"Horror,Mystery",6.8,92.0
95,"Feb 2, 2018",Winchester,3500000,25091816,44378040,69469856,65969856,1884.8530285714287,"Biography,Drama,Fantasy",5.4,99.0
97,"Feb 22, 2013",Dark Skies,3500000,17418667,27704111,45122778,41622778,1189.2222285714286,"Horror,Sci-Fi,Thriller",6.3,97.0
98,"Jan 19, 2018",Forever My Girl,3500000,16376066,16376066,32752132,29252132,835.7751999999999,"Drama,Music,Romance",6.7,108.0
2,"Jun 21, 1972",Frenzy,3500000,12600000,12600000,25200000,21700000,620.0,Thriller,8.1,90.0
2,"Jun 21, 1972",Frenzy,3500000,12600000,12600000,25200000,21700000,620.0,Drama,7.4,119.0
5,"Aug 23, 1996",She's the One,3500000,9482579,13795053,23277632,19777632,565.0752,"Drama,Romance",6.7,110.0
11,"May 18, 2018",First Reformed,3500000,3448256,3874772,7323028,3823028,109.22937142857143,"Drama,Mystery,Thriller",7.1,113.0
13,"Dec 2, 2016",Believe,3500000,890303,890303,1780606,-1719394,-49.125542857142854,"Drama,Sport",5.7,96.0
13,"Dec 2, 2016",Believe,3500000,890303,890303,1780606,-1719394,-49.125542857142854,Drama,5.0,119.0
15,"Sep 30, 2016",American Honey,3500000,663247,2611750,3274997,-225003,-6.428657142857143,"Adventure,Drama,Romance",7.0,163.0
16,"Mar 18, 2016",The Bronze,3500000,615816,615816,1231632,-2268368,-64.81051428571428,"Comedy,Drama,Sport",6.0,100.0
19,"Jan 8, 2016",The Masked Saint,3500000,182695,182695,365390,-3134610,-89.56028571428571,"Action,Biography,Crime",4.6,105.0
22,"Jun 3, 2016",Time to Choose,3500000,29233,29233,58466,-3441534,-98.32954285714285,Documentary,7.5,100.0
25,"Dec 31, 2011",The Kick,3500000,0,40622,40622,-3459378,-98.83937142857143,"Action,Sport",5.7,94.0
27,"Oct 1, 2006",The Secret,3500000,0,0,0,-3500000,-100.0,Documentary,6.3,89.0
27,"Oct 1, 2006",The Secret,3500000,0,0,0,-3500000,-100.0,"Drama,Mystery,Romance",6.1,109.0
32,"Jun 5, 2015",Dawn Patrol,3500000,0,0,0,-3500000,-100.0,"Drama,Thriller",4.8,88.0
34,"Sep 1, 2015",Lords of London,3440000,0,0,0,-3440000,-100.0,"Crime,Mystery,Thriller",3.2,90.0
37,"Oct 21, 2011",Margin Call,3400000,5353586,20433227,25786813,22386813,658.4356764705882,"Drama,Thriller",7.1,107.0
40,"Jul 11, 2008",August,3400000,12636,12636,25272,-3374728,-99.25670588235293,"Drama,Romance",5.9,99.0
40,"Jul 11, 2008",August,3400000,12636,12636,25272,-3374728,-99.25670588235293,Drama,5.3,108.0
40,"Jul 11, 2008",August,3400000,12636,12636,25272,-3374728,-99.25670588235293,Drama,4.2,72.0
43,"Oct 10, 2014",Whiplash,3300000,13092006,38969037,52061043,48761043,1477.6073636363635,"Drama,Music",8.5,106.0
48,"Jan 20, 2015",The Opposite Sex,3300000,0,50206,50206,-3249794,-98.47860606060605,Comedy,4.6,97.0
53,"Jun 12, 1968",Rosemary's Baby,3200000,33395426,33395426,66790852,63590852,1987.214125,Comedy,7.7,48.0
54,"Jul 6, 2018",Sorry to Bother You,3200000,17493096,18285560,35778656,32578656,1018.0830000000001,"Comedy,Fantasy,Sci-Fi",7.0,111.0
57,"Jun 3, 2011",Beginners,3200000,5790894,14314407,20105301,16905301,528.29065625,"Comedy,Drama,Romance",7.2,105.0
58,"Apr 22, 2016",The Meddler,3200000,4267219,5526942,9794161,6594161,206.06753125,"Comedy,Drama,Romance",6.3,103.0
59,"Jul 29, 2009",Adam,3200000,2283291,2834485,5117776,1917776,59.930499999999995,Drama,6.3,98.0
59,"Jul 29, 2009",Adam,3200000,2283291,2834485,5117776,1917776,59.930499999999995,Drama,7.8,123.0
59,"Jul 29, 2009",Adam,3200000,2283291,2834485,5117776,1917776,59.930499999999995,Comedy,6.8,95.0
59,"Jul 29, 2009",Adam,3200000,2283291,2834485,5117776,1917776,59.930499999999995,Drama,5.6,72.0
63,"Apr 12, 2013",Antiviral,3100000,0,123407,123407,-2976593,-96.01912903225806,"Horror,Sci-Fi,Thriller",5.7,108.0
65,"Oct 20, 2010",Paranormal Activity 2,3000000,84752907,177512032,262264939,259264939,8642.164633333332,Horror,5.7,91.0
66,"Aug 28, 2015",War Room,3000000,67790117,73975239,141765356,138765356,4625.511866666667,Drama,6.5,120.0
67,"Jun 7, 2013",The Purge,3000000,64473115,91266581,155739696,152739696,5091.3232,"Horror,Thriller",5.7,85.0
69,"Oct 12, 2012",Sinister,3000000,48086903,87727807,135814710,132814710,4427.156999999999,"Horror,Mystery,Thriller",6.8,110.0
72,"Jan 1, 1978",Coming Home,3000000,32653000,32653000,65306000,62306000,2076.866666666667,"Documentary,Drama",6.9,86.0
72,"Jan 1, 1978",Coming Home,3000000,32653000,32653000,65306000,62306000,2076.866666666667,"Drama,Romance",7.3,109.0
72,"Jan 1, 1978",Coming Home,3000000,32653000,32653000,65306000,62306000,2076.866666666667,Drama,6.0,90.0
89,"Jun 1, 2018",Upgrade,3000000,11977130,16553285,28530415,25530415,851.0138333333334,"Action,Sci-Fi,Thriller",7.6,100.0
97,"Aug 26, 1948",Red River,3000000,9012000,9012000,18024000,15024000,500.8,Horror,2.3,77.0
99,"May 24, 2013",Before Midnight,3000000,8110621,23251930,31362551,28362551,945.4183666666668,"Drama,Romance",7.9,109.0
1,"Jul 31, 2009",The Collector,3000000,7712114,10473836,18185950,15185950,506.1983333333333,"Action,Comedy",7.1,94.0
3,"Oct 27, 2017",Let There Be Light,3000000,7233471,7241309,14474780,11474780,382.4926666666667,Drama,4.8,100.0
3,"Oct 27, 2017",Let There Be Light,3000000,7233471,7241309,14474780,11474780,382.4926666666667,Documentary,6.7,80.0
8,"Apr 28, 2006",Water,3000000,5529144,11322573,16851717,13851717,461.72389999999996,Drama,7.6,120.0
10,"Jun 24, 2016",Swiss Army Man,3000000,4210454,5837111,10047565,7047565,234.9188333333333,"Adventure,Comedy,Drama",7.0,97.0
14,"May 17, 2013",Frances Ha,3000000,4067398,11262769,15330167,12330167,411.00556666666665,"Comedy,Drama,Romance",7.4,86.0
15,"Apr 30, 2010",Please Give,3000000,4033574,4570178,8603752,5603752,186.79173333333335,"Comedy,Drama",6.6,87.0
21,"Apr 22, 2016",Compadres,3000000,3127773,7445044,10572817,7572817,252.42723333333333,"Action,Comedy,Crime",4.7,101.0
25,"Apr 9, 2010",Letters to God,3000000,2848587,3237452,6086039,3086039,102.86796666666666,"Drama,Family",6.3,110.0
26,"Oct 16, 1998",Happiness,3000000,2746453,5746453,8492906,5492906,183.09686666666667,"Documentary,Drama,Family",7.1,80.0
26,"Oct 16, 1998",Happiness,3000000,2746453,5746453,8492906,5492906,183.09686666666667,Drama,6.3,90.0
26,"Oct 16, 1998",Happiness,3000000,2746453,5746453,8492906,5492906,183.09686666666667,Drama,7.2,111.0
28,"Sep 19, 2014",Tusk,3000000,1821983,1887554,3709537,709537,23.651233333333334,"Comedy,Drama,Horror",5.3,102.0
29,"May 12, 2017",The Wall,3000000,1803064,4495262,6298326,3298326,109.94420000000001,Documentary,9.2,78.0
29,"May 12, 2017",The Wall,3000000,1803064,4495262,6298326,3298326,109.94420000000001,"Drama,Fantasy,Mystery",6.8,108.0
29,"May 12, 2017",The Wall,3000000,1803064,4495262,6298326,3298326,109.94420000000001,"Action,Drama,Thriller",6.2,88.0
29,"May 12, 2017",The Wall,3000000,1803064,4495262,6298326,3298326,109.94420000000001,Drama,6.7,73.0
31,"Apr 6, 2012",Damsels in Distress,3000000,1007535,1324299,2331834,-668166,-22.2722,"Comedy,Drama,Romance",5.7,99.0
32,"Mar 25, 2005",Oldboy,3000000,707391,6239723,6947114,3947114,131.57046666666668,"Action,Drama,Mystery",5.8,104.0
33,"May 6, 2011",Hobo with a Shotgun,3000000,703372,834953,1538325,-1461675,-48.722500000000004,"Action,Comedy,Horror",6.1,86.0
34,"May 8, 2015",The D Train,3000000,669688,772366,1442054,-1557946,-51.931533333333334,"Comedy,Drama",5.0,101.0
35,"Sep 7, 2012",Bachelorette,3000000,446770,12577401,13024171,10024171,334.1390333333334,"Comedy,Romance",5.3,87.0
38,"Sep 9, 2011",Creature,3000000,331000,331000,662000,-2338000,-77.93333333333334,Horror,3.7,93.0
38,"Sep 9, 2011",Creature,3000000,331000,331000,662000,-2338000,-77.93333333333334,"Action,Horror,Sci-Fi",3.2,134.0
39,"Dec 9, 2016",The Bounce Back,3000000,321910,421404,743314,-2256686,-75.22286666666666,"Comedy,Romance",5.0,104.0
40,"Aug 23, 1996",Freeway,3000000,295493,295493,590986,-2409014,-80.30046666666667,Drama,5.9,90.0
44,"Mar 2, 2012",Tim and Eric's Billion Dollar Movie,3000000,201436,223652,425088,-2574912,-85.8304,Comedy,5.4,93.0
49,"Aug 15, 2014",Fort McCoy,3000000,78948,78948,157896,-2842104,-94.7368,"Drama,History,War",5.9,100.0
50,"Aug 4, 1999",The Gambler,3000000,51773,101773,153546,-2846454,-94.8818,Drama,7.0,105.0
50,"Aug 4, 1999",The Gambler,3000000,51773,101773,153546,-2846454,-94.8818,"Crime,Drama,Thriller",6.0,111.0
50,"Aug 4, 1999",The Gambler,3000000,51773,101773,153546,-2846454,-94.8818,Documentary,7.6,52.0
50,"Aug 4, 1999",The Gambler,3000000,51773,101773,153546,-2846454,-94.8818,"Drama,Thriller",7.2,109.0
50,"Aug 4, 1999",The Gambler,3000000,51773,101773,153546,-2846454,-94.8818,"Action,Sci-Fi,Thriller",6.1,121.0
52,"Sep 4, 2015",Before We Go,3000000,37151,483938,521089,-2478911,-82.63036666666666,"Comedy,Drama,Romance",6.8,95.0
52,"Sep 4, 2015",Before We Go,3000000,37151,483938,521089,-2478911,-82.63036666666666,"Documentary,Drama,News",7.0,84.0
53,"Jan 13, 2012",The Divide,3000000,18000,156362,174362,-2825638,-94.18793333333333,"Drama,Horror,Sci-Fi",5.8,112.0
53,"Jan 13, 2012",The Divide,3000000,18000,156362,174362,-2825638,-94.18793333333333,Documentary,6.7,78.0
56,"Oct 10, 2017",Demonic,3000000,0,4668109,4668109,1668109,55.603633333333335,"Horror,Thriller",5.3,83.0
56,"Oct 10, 2017",Demonic,3000000,0,4668109,4668109,1668109,55.603633333333335,Documentary,5.7,28.0
58,"Jun 27, 2014",They Came Together,3000000,0,82780,82780,-2917220,-97.24066666666667,"Comedy,Romance",5.5,83.0
59,"May 21, 2013",Open Road,3000000,0,47469,47469,-2952531,-98.4177,"Action,Drama,Thriller",5.5,85.0
60,"Jul 28, 1951",Alice in Wonderland,3000000,0,0,0,-3000000,-100.0,"Adventure,Family,Fantasy",6.5,108.0
60,"Jul 28, 1951",Alice in Wonderland,3000000,0,0,0,-3000000,-100.0,"Fantasy,Musical",6.5,99.0
61,"Oct 1, 2010",Barry Munday,3000000,0,0,0,-3000000,-100.0,"Comedy,Drama,Romance",5.9,95.0
65,"Dec 31, 2015",AWOL-72,3000000,0,0,0,-3000000,-100.0,"Action,Thriller",3.8,82.0
67,"Feb 6, 2015",Enter the Dangerous Mind,3000000,0,0,0,-3000000,-100.0,Thriller,5.2,88.0
68,"Mar 17, 2015",Something Wicked,3000000,0,0,0,-3000000,-100.0,"Drama,Horror,Mystery",4.8,95.0
69,"Sep 18, 1967",Point Blank,3000000,0,0,0,-3000000,-100.0,"Action,Crime,Drama",6.8,81.0
69,"Sep 18, 1967",Point Blank,3000000,0,0,0,-3000000,-100.0,"Crime,Documentary,History",8.2,92.0
72,"Aug 14, 2015",Amnesiac,3000000,0,0,0,-3000000,-100.0,"Drama,Horror,Thriller",2.3,90.0
72,"Aug 14, 2015",Amnesiac,3000000,0,0,0,-3000000,-100.0,"Drama,Horror,Mystery",4.3,90.0
73,"Dec 31, 2015",Unnatural,3000000,0,0,0,-3000000,-100.0,"Action,Horror,Sci-Fi",4.0,89.0
74,"Dec 11, 2015",Close Range,3000000,0,0,0,-3000000,-100.0,"Action,Crime",5.0,80.0
76,"Feb 15, 1950",Cinderella,2900000,85000000,263591415,348591415,345691415,11920.393620689656,"Drama,Family,Fantasy",6.9,105.0
80,"Oct 1, 2010",Freakonomics,2900000,101270,172867,274137,-2625863,-90.547,Documentary,6.4,93.0
81,"Aug 19, 2011",Griff the Invisible,2900000,20778,25935,46713,-2853287,-98.38920689655173,"Comedy,Drama,Romance",6.1,90.0
93,"Oct 26, 2018",Indivisible,2700000,3511417,3588305,7099722,4399722,162.95266666666666,Documentary,7.2,78.0
93,"Oct 26, 2018",Indivisible,2700000,3511417,3588305,7099722,4399722,162.95266666666666,Drama,7.1,100.0
93,"Oct 26, 2018",Indivisible,2700000,3511417,3588305,7099722,4399722,162.95266666666666,"Drama,War",5.6,119.0
95,"Dec 31, 2015",Sardaar Ji,2700000,0,8200000,8200000,5500000,203.70370370370372,"Comedy,Fantasy,Horror",6.5,141.0
98,"Jan 12, 1956",Diane,2660000,0,0,0,-2660000,-100.0,"Crime,Drama,Horror",4.6,82.0
98,"Jan 12, 1956",Diane,2660000,0,0,0,-2660000,-100.0,Drama,6.5,95.0
3,"May 2, 2014",Ida,2600000,3827060,15298355,19125415,16525415,635.5928846153846,Drama,7.4,82.0
10,"Apr 1, 2011","Fat, Sick & Nearly Dead",2600000,0,0,0,-2600000,-100.0,Documentary,7.6,97.0
12,"Jan 11, 2013",A Haunted House,2500000,40041683,59922558,99964241,97464241,3898.56964,"Comedy,Fantasy",5.1,86.0
14,"Jul 3, 2013",Kevin Hart: Let Me Explain,2500000,32244051,32327255,64571306,62071306,2482.85224,"Comedy,Documentary",6.8,75.0
22,"Aug 2, 2013",The Spectacular Now,2500000,6852971,6916951,13769922,11269922,450.79688000000004,"Comedy,Drama,Romance",7.1,95.0
24,"Jan 27, 1995",Before Sunrise,2500000,5274005,5690220,10964225,8464225,338.56899999999996,Drama,6.6,70.0
25,"Jun 24, 2016",Hunt for the Wilderpeople,2500000,5205471,23845533,29051004,26551004,1062.04016,"Adventure,Comedy,Drama",7.9,101.0
26,"Aug 17, 2012",Robot & Frank,2500000,3317468,4934356,8251824,5751824,230.07296,"Comedy,Crime,Drama",7.1,89.0
31,"Mar 1, 2013",The Lost Medallion: The Adventures of Billy Stone,2500000,549632,549632,1099264,-1400736,-56.029439999999994,"Adventure,Family,Fantasy",4.9,97.0
34,"Apr 1, 2011",Super,2500000,327716,593933,921649,-1578351,-63.13404,"Action,Comedy,Drama",6.8,96.0
34,"Apr 1, 2011",Super,2500000,327716,593933,921649,-1578351,-63.13404,Drama,8.1,140.0
38,"Jun 18, 2010",8: The Mormon Proposition,2500000,100280,100280,200560,-2299440,-91.97760000000001,Documentary,7.0,80.0
41,"Aug 16, 2013",Underdogs,2500000,35017,1392649,1427666,-1072334,-42.89336,"Adventure,Animation,Family",6.5,106.0
41,"Aug 16, 2013",Underdogs,2500000,35017,1392649,1427666,-1072334,-42.89336,"Drama,Family,Sport",5.8,102.0
43,"Dec 31, 2009",The Calling,2500000,0,0,0,-2500000,-100.0,"Drama,Thriller",5.8,108.0
43,"Dec 31, 2009",The Calling,2500000,0,0,0,-2500000,-100.0,Biography,6.7,46.0
44,"Jun 21, 2013",Alien Uprising,2500000,0,0,0,-2500000,-100.0,"Comedy,Horror,Sci-Fi",3.2,101.0
45,"Dec 31, 2010",Christmas Mail,2500000,0,0,0,-2500000,-100.0,"Comedy,Drama,Family",5.8,89.0
46,"Jul 3, 2015",Stung,2500000,0,0,0,-2500000,-100.0,"Action,Adventure,Comedy",5.1,87.0
48,"Oct 13, 2015",8 Days,2500000,0,0,0,-2500000,-100.0,"Drama,Thriller",5.0,90.0
49,"Sep 2, 2016",Antibirth,2500000,0,0,0,-2500000,-100.0,Horror,4.9,94.0
50,"Feb 2, 2016",The Rise of the Krays,2500000,0,0,0,-2500000,-100.0,"Crime,Drama",5.0,110.0
57,"Nov 14, 2014",Always Woodstock,2400000,0,0,0,-2400000,-100.0,"Comedy,Music,Romance",5.4,97.0
60,"Mar 20, 2015",Do You Believe?,2300000,12985600,14304931,27290531,24990531,1086.5448260869564,Drama,6.1,120.0
60,"Mar 20, 2015",Do You Believe?,2300000,12985600,14304931,27290531,24990531,1086.5448260869564,"Fantasy,Horror",3.8,71.0
63,"Sep 5, 2014",Frontera,2300000,59696,59696,119392,-2180608,-94.80904347826086,"Drama,Thriller,Western",6.6,103.0
64,"Aug 26, 2011",Redemption Road,2300000,29384,29384,58768,-2241232,-97.4448695652174,Drama,5.8,95.0
66,"Jan 19, 2016",Eden,2300000,0,0,0,-2300000,-100.0,"Crime,Drama",6.7,98.0
66,"Jan 19, 2016",Eden,2300000,0,0,0,-2300000,-100.0,"Comedy,Drama",6.9,101.0
66,"Jan 19, 2016",Eden,2300000,0,0,0,-2300000,-100.0,"Drama,Thriller",4.7,90.0
66,"Jan 19, 2016",Eden,2300000,0,0,0,-2300000,-100.0,"Biography,Drama,Music",6.4,131.0
66,"Jan 19, 2016",Eden,2300000,0,0,0,-2300000,-100.0,"Crime,Drama",8.0,85.0
66,"Jan 19, 2016",Eden,2300000,0,0,0,-2300000,-100.0,Drama,6.7,97.0
68,"Feb 9, 1940",Pinocchio,2289247,84300000,84300000,168600000,166310753,7264.867137534743,"Animation,Family,Fantasy",6.3,75.0
68,"Feb 9, 1940",Pinocchio,2289247,84300000,84300000,168600000,166310753,7264.867137534743,Documentary,6.8,75.0
69,"Nov 13, 1940",Fantasia,2280000,83320000,83320000,166640000,164360000,7208.771929824562,Drama,5.5,86.0
79,"Jul 13, 2001",Bully,2100000,881824,1381824,2263648,163648,7.792761904761905,Documentary,7.4,98.0
79,"Jul 13, 2001",Bully,2100000,881824,1381824,2263648,163648,7.792761904761905,Music,6.3,112.0
79,"Jul 13, 2001",Bully,2100000,881824,1381824,2263648,163648,7.792761904761905,Drama,7.6,102.0
79,"Jul 13, 2001",Bully,2100000,881824,1381824,2263648,163648,7.792761904761905,Comedy,5.7,83.0
79,"Jul 13, 2001",Bully,2100000,881824,1381824,2263648,163648,7.792761904761905,"Drama,Musical",7.9,58.0
81,"Oct 16, 2016",Mi America,2100000,3330,3330,6660,-2093340,-99.68285714285715,"Crime,Drama",6.5,90.0
83,"Dec 31, 2012",Infected,2100000,0,0,0,-2100000,-100.0,"Action,Horror,Sci-Fi",2.8,95.0
83,"Dec 31, 2012",Infected,2100000,0,0,0,-2100000,-100.0,"Action,Horror,Sci-Fi",3.8,116.0
85,"Oct 6, 2015",The Timber,2100000,0,0,0,-2100000,-100.0,"Action,Adventure,Drama",4.9,81.0
86,"Jan 19, 2016",Sharkskin,2100000,0,0,0,-2100000,-100.0,"Comedy,Drama,Mystery",6.4,100.0
87,"Sep 30, 2011",Courageous,2000000,34522221,35185884,69708105,67708105,3385.4052500000003,Drama,7.0,129.0
92,"Dec 17, 1973",Sleeper,2000000,18344729,18344729,36689458,34689458,1734.4729000000002,"Action,Horror",3.8,86.0
94,"Mar 13, 2015",It Follows,2000000,14674077,23250755,37924832,35924832,1796.2416,"Horror,Mystery",6.9,100.0
95,"Jul 13, 2018",Eighth Grade,2000000,13539710,14341016,27880726,25880726,1294.0363,"Comedy,Drama",7.5,93.0
97,"Mar 9, 2012",Silent House,2000000,12739737,16610760,29350497,27350497,1367.52485,"Drama,Horror,Mystery",5.3,86.0
100,"Apr 8, 2016",Hardcore Henry,2000000,9252038,17187434,26439472,24439472,1221.9736,"Action,Adventure,Sci-Fi",6.7,96.0
8,"Jun 11, 2010",Winter's Bone,2000000,6531503,16131551,22663054,20663054,1033.1526999999999,"Drama,Mystery",7.2,100.0
9,"Oct 10, 2014",Meet the Mormons,2000000,6047363,6049171,12096534,10096534,504.8267,Documentary,6.9,78.0
11,"Oct 6, 2017",The Florida Project,2000000,5904366,11295324,17199690,15199690,759.9845,Drama,7.6,111.0
12,"Aug 25, 2017",All Saints,2000000,5802208,5941994,11744202,9744202,487.21009999999995,Drama,6.0,108.0
15,"Aug 20, 2003",Thirteen,2000000,4601043,9505996,14107039,12107039,605.35195,Drama,6.3,100.0
17,"Oct 8, 2010",Inside Job,2000000,4311834,7799257,12111091,10111091,505.55455,"Crime,Documentary",8.3,109.0
20,"Aug 28, 2015",We Are Your Friends,2000000,3591417,10153415,13744832,11744832,587.2416000000001,"Drama,Music,Romance",6.2,96.0
23,"Sep 18, 2015",Captive,2000000,2583301,2791973,5375274,3375274,168.7637,"Drama,Thriller",6.0,120.0
23,"Sep 18, 2015",Captive,2000000,2583301,2791973,5375274,3375274,168.7637,"Action,Thriller",3.8,88.0
23,"Sep 18, 2015",Captive,2000000,2583301,2791973,5375274,3375274,168.7637,"Action,Crime,Drama",5.4,97.0
25,"Jun 8, 2018",Hearts Beat Loud,2000000,2386254,2420962,4807216,2807216,140.36079999999998,"Comedy,Drama,Music",6.9,97.0
26,"Jan 20, 2017",The Resurrection of Gavin Stone,2000000,2303792,2303792,4607584,2607584,130.3792,"Comedy,Drama,Family",6.2,91.0
30,"Jan 29, 1993",Nemesis,2000000,2001124,2001124,4002248,2002248,100.1124,Drama,6.6,83.0
34,"May 12, 2000",Hamlet,2000000,1577287,2419669,3996956,1996956,99.84779999999999,Drama,5.4,88.0
34,"May 12, 2000",Hamlet,2000000,1577287,2419669,3996956,1996956,99.84779999999999,Drama,5.6,90.0
34,"May 12, 2000",Hamlet,2000000,1577287,2419669,3996956,1996956,99.84779999999999,Drama,6.5,184.0
34,"May 12, 2000",Hamlet,2000000,1577287,2419669,3996956,1996956,99.84779999999999,Drama,8.6,217.0
34,"May 12, 2000",Hamlet,2000000,1577287,2419669,3996956,1996956,99.84779999999999,Drama,7.6,166.0
35,"Aug 7, 2015",The Diary of a Teenage Girl,2000000,1477002,2279959,3756961,1756961,87.84805,"Comedy,Drama,Romance",6.9,102.0
37,"Apr 25, 2014",Locke,2000000,1370646,2088390,3459036,1459036,72.9518,Drama,7.1,85.0
40,"Apr 8, 2011",Meek's Cutoff,2000000,977772,1869928,2847700,847700,42.385,"Drama,Western",6.6,104.0
41,"Nov 28, 2014",The Babadook,2000000,950792,7482387,8433179,6433179,321.65895,"Drama,Horror",6.8,94.0
44,"Sep 24, 2010",The Virginity Hit,2000000,636706,636706,1273412,-726588,-36.3294,Comedy,4.6,86.0
48,"Jan 18, 2008",Teeth,2000000,347578,2350641,2698219,698219,34.91095,Drama,8.8,71.0
49,"Jul 26, 1996",Stonewall,2000000,304602,304602,609204,-1390796,-69.5398,"Drama,History",5.1,129.0
51,"Feb 13, 2015",The Last Five Years,2000000,147299,205298,352597,-1647403,-82.37015,"Comedy,Drama,Musical",5.9,94.0
57,"Sep 19, 2014",Pump,2000000,72277,72277,144554,-1855446,-92.7723,Documentary,7.7,88.0
60,"Apr 7, 2015",Lost River,2000000,45431,2009644,2055075,55075,2.75375,"Drama,Fantasy,Mystery",5.8,95.0
62,"Oct 9, 2015",Knock Knock,2000000,36336,6328516,6364852,4364852,218.2426,"Drama,Thriller",4.9,99.0
62,"Oct 9, 2015",Knock Knock,2000000,36336,6328516,6364852,4364852,218.2426,Horror,6.0,55.0
67,"Oct 19, 2012",The First Time,2000000,17061,17061,34122,-1965878,-98.29390000000001,"Comedy,Drama,Romance",6.9,95.0
69,"Aug 27, 2010",Circle,2000000,10024,10024,20048,-1979952,-98.99759999999999,"Horror,Thriller",3.4,88.0
69,"Aug 27, 2010",Circle,2000000,10024,10024,20048,-1979952,-98.99759999999999,"Drama,Mystery,Sci-Fi",6.0,87.0
73,"Sep 13, 2013",Plush,2000000,3080,28864,31944,-1968056,-98.4028,"Drama,Music,Thriller",5.4,99.0
74,"Oct 26, 2012",The Ghastly Love of Johnny X,2000000,2436,2436,4872,-1995128,-99.7564,"Comedy,Fantasy,Musical",5.7,106.0
76,"Sep 9, 2011",Grave Encounters,2000000,0,2151887,2151887,151887,7.5943499999999995,Horror,6.1,92.0
77,"Oct 23, 2015",Bone Tomahawk,2000000,0,475846,475846,-1524154,-76.2077,"Adventure,Drama,Horror",7.1,132.0
79,"Apr 1, 2013",Stitches,2000000,0,63555,63555,-1936445,-96.82225,Horror,7.2,71.0
79,"Apr 1, 2013",Stitches,2000000,0,63555,63555,-1936445,-96.82225,"Comedy,Horror",5.7,86.0
79,"Apr 1, 2013",Stitches,2000000,0,63555,63555,-1936445,-96.82225,"Drama,Thriller",7.8,105.0
79,"Apr 1, 2013",Stitches,2000000,0,63555,63555,-1936445,-96.82225,Drama,5.8,103.0
82,"Dec 31, 2009",Nine Dead,2000000,0,0,0,-2000000,-100.0,"Crime,Drama,Horror",5.5,98.0
84,"Jul 7, 2007",Rockaway,2000000,0,0,0,-2000000,-100.0,"Adventure,Drama",6.4,90.0
85,"Aug 12, 1927",Wings,2000000,0,0,0,-2000000,-100.0,"Adventure,Animation,Comedy",3.2,84.0
87,"Mar 19, 2013",Straight A's,2000000,0,0,0,-2000000,-100.0,"Comedy,Drama",5.7,91.0
89,"Dec 31, 2012",Highway,2000000,0,0,0,-2000000,-100.0,Comedy,3.5,77.0
89,"Dec 31, 2012",Highway,2000000,0,0,0,-2000000,-100.0,Drama,6.7,80.0
89,"Dec 31, 2012",Highway,2000000,0,0,0,-2000000,-100.0,"Crime,Drama,Romance",7.7,133.0
89,"Dec 31, 2012",Highway,2000000,0,0,0,-2000000,-100.0,Drama,6.2,110.0
90,"Feb 8, 2013",Small Apartments,2000000,0,0,0,-2000000,-100.0,"Comedy,Crime,Drama",6.1,96.0
91,"Jul 9, 2013",Coffee Town,2000000,0,0,0,-2000000,-100.0,Comedy,6.6,87.0
92,"Dec 31, 2014",Lucky Dog,2000000,0,0,0,-2000000,-100.0,Family,5.4,88.0
96,"Mar 20, 2015",The Walking Deceased,2000000,0,0,0,-2000000,-100.0,"Comedy,Horror",3.5,88.0
97,"Dec 31, 2011",True Bromance,2000000,0,0,0,-2000000,-100.0,Comedy,5.9,96.0
98,"Aug 21, 2015",The Curse of Downers Grove,2000000,0,0,0,-2000000,-100.0,"Drama,Horror,Mystery",4.5,89.0
99,"Dec 31, 2015",Wind Walkers,2000000,0,0,0,-2000000,-100.0,"Action,Horror,Thriller",3.8,93.0
100,"Jul 8, 2016",The Dog Lover,2000000,0,0,0,-2000000,-100.0,Drama,5.6,101.0
1,"Dec 1, 2015",Shark Lake,2000000,0,0,0,-2000000,-100.0,"Action,Adventure,Crime",3.5,92.0
2,"Sep 24, 2010",Buried,1987650,1044143,21270290,22314433,20326783,1022.6540386889039,"Drama,Mystery,Thriller",7.0,95.0
2,"Sep 24, 2010",Buried,1987650,1044143,21270290,22314433,20326783,1022.6540386889039,Thriller,6.0,95.0
4,"May 8, 1987",River's Edge,1900000,4600000,4600000,9200000,7300000,384.2105263157895,Crime,6.3,118.0
8,"Apr 24, 2015",Brotherly Love,1900000,478595,478595,957190,-942810,-49.62157894736842,Drama,6.7,89.0
8,"Apr 24, 2015",Brotherly Love,1900000,478595,478595,957190,-942810,-49.62157894736842,Drama,5.8,118.0
9,"Jun 3, 2011",Submarine,1900000,467602,4581937,5049539,3149539,165.7652105263158,"Comedy,Drama,Romance",7.3,97.0
10,"Apr 9, 2010",The Square,1900000,406216,740932,1147148,-752852,-39.62378947368421,"Documentary,Drama,History",8.1,108.0
10,"Apr 9, 2010",The Square,1900000,406216,740932,1147148,-752852,-39.62378947368421,"Comedy,Drama",7.2,151.0
11,"Feb 8, 2013",ABCD (Any Body Can Dance),1900000,222098,10137234,10359332,8459332,445.228,"Drama,Music",6.4,160.0
13,"Jul 26, 2013",Stranded,1900000,0,285593,285593,-1614407,-84.96878947368421,"Horror,Mystery",5.1,103.0
13,"Jul 26, 2013",Stranded,1900000,0,285593,285593,-1614407,-84.96878947368421,"Horror,Sci-Fi",3.5,84.0
13,"Jul 26, 2013",Stranded,1900000,0,285593,285593,-1614407,-84.96878947368421,Documentary,7.9,62.0
14,"Dec 31, 2015",Vaalu,1900000,0,12444,12444,-1887556,-99.34505263157895,"Comedy,Romance",4.9,155.0
15,"Aug 27, 2010",The Last Exorcism,1800000,41034350,70165900,111200250,109400250,6077.791666666667,"Drama,Horror,Thriller",5.6,87.0
16,"Nov 16, 1976",Carrie,1800000,25878153,25878153,51756306,49956306,2775.3503333333333,"Drama,Horror",5.9,100.0
17,"Nov 9, 1984",A Nightmare on Elm Street,1800000,25504513,25504513,51009026,49209026,2733.8347777777776,"Crime,Drama,Horror",5.2,95.0
18,"Jun 27, 2012",Beasts of the Southern Wild,1800000,12795746,23265132,36060878,34260878,1903.3821111111113,"Adventure,Drama,Fantasy",7.3,93.0
25,"Aug 23, 2011",Higher Ground,1800000,841056,842693,1683749,-116251,-6.458388888888889,Drama,6.3,109.0
29,"Dec 31, 2009",Deadline,1800000,0,0,0,-1800000,-100.0,"Drama,Mystery,Thriller",4.8,95.0
29,"Dec 31, 2009",Deadline,1800000,0,0,0,-1800000,-100.0,"Mystery,Thriller",6.7,83.0
29,"Dec 31, 2009",Deadline,1800000,0,0,0,-1800000,-100.0,"Comedy,Romance",8.5,95.0
31,"Feb 3, 2012",Dysfunctional Friends,1800000,0,0,0,-1800000,-100.0,"Comedy,Drama",5.2,111.0
32,"Dec 31, 2013",Independence Daysaster,1800000,0,0,0,-1800000,-100.0,"Action,Adventure,Sci-Fi",3.4,90.0
37,"Oct 8, 2010",I Spit on Your Grave,1750000,93051,1278471,1371522,-378478,-21.627314285714284,"Horror,Thriller",6.3,108.0
38,"Apr 23, 2019",Living Dark: The Story of Ted the Caver,1750000,0,0,0,-1750000,-100.0,Horror,5.3,112.0
42,"Feb 28, 2014",The Lunchbox,1700000,4231500,12231500,16463000,14763000,868.4117647058823,"Drama,Romance",7.8,104.0
43,"Oct 4, 2013",Grace Unplugged,1700000,2507159,2507159,5014318,3314318,194.95988235294118,"Drama,Music",6.2,102.0
47,"Jun 24, 2005",Yes,1700000,396035,661221,1057256,-642744,-37.808470588235295,"Adventure,Biography,Documentary",8.7,80.0
48,"Feb 1, 2019",Braid,1660000,0,80745,80745,-1579255,-95.13584337349398,"Horror,Mystery,Thriller",5.3,82.0
54,"Oct 15, 2010",N-Secure,1600000,2595644,2595644,5191288,3591288,224.4555,"Crime,Drama,Thriller",3.6,105.0
56,"Dec 31, 1989",Out of the Dark,1600000,419428,419428,838856,-761144,-47.5715,"Horror,Thriller",4.8,92.0
60,"Sep 26, 2014",Two Night Stand,1600000,15600,868081,883681,-716319,-44.7699375,"Comedy,Romance",6.4,86.0
63,"Apr 1, 2011",Insidious,1500000,54009150,99870886,153880036,152380036,10158.669066666667,"Horror,Mystery,Thriller",6.9,103.0
64,"Oct 21, 2016",Moonlight,1500000,27854931,65245512,93100443,91600443,6106.696199999999,Drama,7.4,111.0
65,"Sep 12, 2003",Cabin Fever,1500000,21158188,30351664,51509852,50009852,3333.990133333333,Horror,3.7,99.0
70,"Mar 23, 2018",Unsane,1500000,7690044,14244931,21934975,20434975,1362.3316666666665,"Drama,Horror,Mystery",6.4,98.0
74,"Oct 31, 1945",Spellbound,1500000,7000000,7000000,14000000,12500000,833.3333333333334,"Comedy,Horror,Romance",6.9,114.0
77,"Jul 26, 2013",The To Do List,1500000,3491669,4128828,7620497,6120497,408.03313333333335,"Comedy,Romance",5.8,104.0
78,"Feb 1, 2013",The Gatekeepers,1500000,2408553,2592308,5000861,3500861,233.39073333333334,"Documentary,History,War",7.6,101.0
84,"Apr 19, 2013",The Lords of Salem,1500000,1165881,1541131,2707012,1207012,80.46746666666667,"Horror,Thriller",5.1,101.0
85,"Oct 21, 2016",31,1500000,779820,922727,1702547,202547,13.503133333333334,"Horror,Thriller",5.1,102.0
87,"Apr 22, 2016",Unsullied,1500000,510957,510957,1021914,-478086,-31.8724,"Action,Horror,Thriller",4.3,93.0
94,"Aug 19, 2011",Amigo,1500000,184705,184705,369410,-1130590,-75.37266666666666,"Drama,War",5.9,124.0
100,"Oct 25, 2013",The Square,1500000,124244,176262,300506,-1199494,-79.96626666666667,"Documentary,Drama,History",8.1,108.0
100,"Oct 25, 2013",The Square,1500000,124244,176262,300506,-1199494,-79.96626666666667,"Comedy,Drama",7.2,151.0
2,"Mar 6, 2015",Road Hard,1500000,113169,113169,226338,-1273662,-84.9108,Comedy,6.1,98.0
7,"Oct 17, 2014",Housebound,1500000,0,236863,236863,-1263137,-84.20913333333333,"Comedy,Horror,Mystery",6.8,107.0
8,"Jul 20, 2018",Teefa in Trouble,1500000,0,98806,98806,-1401194,-93.41293333333334,"Action,Comedy,Crime",7.4,155.0
10,"Apr 17, 2014",Closer to the Moon,1500000,0,5396,5396,-1494604,-99.64026666666666,"Comedy,Crime,Drama",7.0,112.0
12,"Jun 3, 2011",The Lion of Judah,1500000,0,0,0,-1500000,-100.0,Animation,3.8,87.0
13,"Nov 11, 2014",Once Upon a Time in Queens,1500000,0,0,0,-1500000,-100.0,"Comedy,Drama",6.2,98.0
15,"May 26, 2015",Mutant World,1500000,0,0,0,-1500000,-100.0,Sci-Fi,2.8,82.0
16,"Nov 20, 2015",#Horror,1500000,0,0,0,-1500000,-100.0,"Crime,Drama,Horror",3.0,101.0
17,"Sep 8, 2015",Checkmate,1500000,0,0,0,-1500000,-100.0,"Drama,Mystery",4.7,121.0
17,"Sep 8, 2015",Checkmate,1500000,0,0,0,-1500000,-100.0,"Action,Crime,Thriller",2.9,102.0
21,"Nov 20, 2015",Mustang,1400000,845464,5552584,6398048,4998048,357.00342857142857,Drama,7.6,97.0
23,"Oct 3, 2014",La chambre bleue,1400000,260441,1945420,2205861,805861,57.561499999999995,Documentary,6.2,48.0
25,"Apr 5, 2013",Eddie: The Sleepwalking Cannibal,1400000,1632,1632,3264,-1396736,-99.76685714285715,"Comedy,Horror",5.6,90.0
26,"May 1, 2010",My Girlfriend's Boyfriend,1400000,0,0,0,-1400000,-100.0,"Comedy,Romance",5.8,84.0
28,"Dec 31, 2014",House at the End of the Drive,1400000,0,0,0,-1400000,-100.0,"Horror,Thriller",6.5,91.0
38,"Jan 30, 2015",Above and Beyond,1300000,288751,288751,577502,-722498,-55.57676923076923,"Adventure,Documentary,History",7.7,90.0
43,"Apr 7, 2006",Simon,1300000,4055,1738663,1742718,442718,34.05523076923077,Thriller,4.8,85.0
44,"May 24, 2011",Forget Me Not,1300000,0,13465,13465,-1286535,-98.96423076923077,Romance,6.6,93.0
44,"May 24, 2011",Forget Me Not,1300000,0,13465,13465,-1286535,-98.96423076923077,Drama,7.3,109.0
44,"May 24, 2011",Forget Me Not,1300000,0,13465,13465,-1286535,-98.96423076923077,"Adventure,Drama",5.6,102.0
44,"May 24, 2011",Forget Me Not,1300000,0,13465,13465,-1286535,-98.96423076923077,Documentary,7.1,83.0
46,"Jun 26, 2015",The Algerian,1300000,0,0,0,-1300000,-100.0,"Action,Romance,Thriller",5.3,99.0
51,"Oct 17, 2014",Dear White People,1250000,4404154,5403771,9807925,8557925,684.634,"Comedy,Drama,Romance",6.1,108.0
52,"Apr 19, 2013",Filly Brown,1250000,2850357,2940411,5790768,4540768,363.26144,"Drama,Music",5.7,80.0
54,"Dec 31, 2016",Bodom,1250000,0,726460,726460,-523540,-41.883199999999995,"Horror,Mystery,Thriller",5.6,65.0
56,"Jan 13, 2015",Da Sweet Blood of Jesus,1250000,0,0,0,-1250000,-100.0,"Comedy,Romance,Thriller",4.1,123.0
66,"Apr 19, 2013",Home Run,1200000,2859955,2859955,5719910,4519910,376.6591666666667,"Drama,Family,Sport",4.2,82.0
66,"Apr 19, 2013",Home Run,1200000,2859955,2859955,5719910,4519910,376.6591666666667,"Drama,Sport",6.0,113.0
72,"Apr 13, 2012",Blue Like Jazz,1200000,595018,595018,1190036,-9964,-0.8303333333333333,"Comedy,Drama",5.9,108.0
74,"Nov 19, 1982",Q,1200000,255000,255000,510000,-690000,-57.49999999999999,Drama,5.6,103.0
74,"Nov 19, 1982",Q,1200000,255000,255000,510000,-690000,-57.49999999999999,"Drama,Thriller",6.4,96.0
76,"Jun 1, 2012","Pink Ribbons, Inc.",1200000,26608,26608,53216,-1146784,-95.56533333333334,Documentary,7.3,97.0
77,"Feb 6, 2018",Blood Feast,1200000,8708,8708,17416,-1182584,-98.54866666666666,Horror,4.9,90.0
83,"Aug 28, 2012",Below Zero,1200000,0,0,0,-1200000,-100.0,Thriller,4.4,99.0
84,"Sep 7, 2012",Crowsnest,1200000,0,0,0,-1200000,-100.0,"Horror,Mystery,Thriller",3.9,84.0
85,"Sep 14, 2012",Airborne,1200000,0,0,0,-1200000,-100.0,"Comedy,Crime,Horror",3.9,81.0
87,"Feb 3, 2015",Bleeding Hearts,1200000,0,0,0,-1200000,-100.0,Horror,3.4,100.0
88,"Dec 31, 2013",The Wicked Within,1200000,0,0,0,-1200000,-100.0,Horror,4.5,84.0
100,"May 18, 2012",Beyond the Black Rainbow,1100000,56491,56491,112982,-987018,-89.7289090909091,"Horror,Sci-Fi,Thriller",6.0,110.0
2,"Nov 21, 2014",The Sleepwalker,1100000,2636,2636,5272,-1094728,-99.52072727272727,Drama,4.9,91.0
3,"Mar 7, 2017",Departure,1100000,0,27561,27561,-1072439,-97.49445454545454,"Drama,Romance",6.7,109.0
7,"Dec 31, 2010",The Dead Undead,1100000,0,0,0,-1100000,-100.0,"Action,Horror,Sci-Fi",3.0,89.0
8,"Dec 31, 2013",The Vatican Exorcisms,1100000,0,0,0,-1100000,-100.0,Horror,2.5,76.0
11,"Nov 21, 1976",Rocky,1000000,117235147,225000000,342235147,341235147,34123.5147,"Action,Comedy,Drama",6.1,136.0
12,"Jan 6, 2012",The Devil Inside,1000000,53262945,101759490,155022435,154022435,15402.2435,Horror,4.2,83.0
14,"Apr 17, 2015",Unfriended,1000000,32789645,64364198,97153843,96153843,9615.3843,"Horror,Mystery,Thriller",5.6,83.0
17,"Aug 23, 2013",You're Next,1000000,18494006,26887177,45381183,44381183,4438.1183,"Action,Comedy,Horror",6.6,95.0
18,"May 25, 2012",Chernobyl Diaries,1000000,18119640,42411721,60531361,59531361,5953.1361,"Horror,Mystery,Thriller",5.0,86.0
19,"Apr 10, 1981",The Howling,1000000,17985000,17985000,35970000,34970000,3497.0,Horror,2.6,83.0
25,"Dec 29, 2010",Blue Valentine,1000000,9737892,16566240,26304132,25304132,2530.4132,"Drama,Romance",7.4,112.0
29,"Jul 20, 2018",Unfriended: Dark Web,1000000,8866745,16434588,25301333,24301333,2430.1333,"Crime,Horror,Mystery",5.9,92.0
31,"Sep 25, 2015",The Green Inferno,1000000,7192291,12931420,20123711,19123711,1912.3711,"Adventure,Horror",5.3,100.0
32,"Feb 3, 2017",I Am Not Your Negro,1000000,7123919,9617402,16741321,15741321,1574.1320999999998,Documentary,7.8,93.0
33,"Oct 19, 2012",The Sessions,1000000,6002451,11495204,17497655,16497655,1649.7655000000002,"Biography,Comedy,Drama",7.2,95.0
35,"Mar 23, 2012",October Baby,1000000,5355847,5391992,10747839,9747839,974.7839000000001,Drama,6.8,107.0
36,"Sep 12, 2014",The Skeleton Twins,1000000,5284309,5797192,11081501,10081501,1008.1501,"Comedy,Drama,Romance",6.8,93.0
41,"Jun 6, 2014",Obvious Child,1000000,3122616,3324070,6446686,5446686,544.6686,"Comedy,Drama,Romance",6.8,84.0
42,"Oct 21, 2011",Martha Marcy May Marlene,1000000,2981038,5438911,8419949,7419949,741.9949,"Drama,Mystery,Thriller",6.9,102.0
52,"Dec 7, 2001",No Man's Land,1000000,1067481,2684207,3751688,2751688,275.16880000000003,"Adventure,Crime,Drama",7.3,118.0
52,"Dec 7, 2001",No Man's Land,1000000,1067481,2684207,3751688,2751688,275.16880000000003,Documentary,7.7,81.0
53,"Oct 9, 1998",Slam,1000000,1009819,1087521,2097340,1097340,109.734,"Comedy,Drama,Romance",6.2,100.0
53,"Oct 9, 1998",Slam,1000000,1009819,1087521,2097340,1097340,109.734,Drama,7.3,115.0
56,"Aug 18, 2017",Patti Cake$,1000000,800148,1471090,2271238,1271238,127.1238,"Drama,Music",6.7,109.0
57,"Dec 1, 2000",Panic,1000000,779137,1425707,2204844,1204844,120.48440000000001,"Drama,Mystery,Thriller",6.1,85.0
58,"May 9, 2014",Palo Alto,1000000,767732,1156309,1924041,924041,92.4041,Drama,6.2,100.0
62,"Jul 29, 2011",The Future,1000000,568662,1239174,1807836,807836,80.7836,"Drama,Fantasy,Romance",6.2,91.0
64,"Oct 24, 2014",23 Blast,1000000,549185,549185,1098370,98370,9.837,"Drama,Family,Sport",6.5,98.0
66,"Jul 19, 2013",The Act of Killing,1000000,486919,1227316,1714235,714235,71.42349999999999,"Crime,Documentary",8.2,117.0
70,"Jul 18, 2014",I Origins,1000000,336472,852399,1188871,188871,18.8871,"Drama,Romance,Sci-Fi",7.4,106.0
71,"Nov 28, 2014",Antarctica: A Year on Ice,1000000,288757,288757,577514,-422486,-42.248599999999996,"Adventure,Biography,Documentary",7.6,91.0
74,"Apr 8, 2016",The Invitation,1000000,231738,354836,586574,-413426,-41.342600000000004,"Drama,Horror,Mystery",6.7,100.0
81,"Jun 1, 2012",Hardflip,1000000,96734,96734,193468,-806532,-80.6532,"Action,Drama",5.6,112.0
82,"Mar 11, 2016",Creative Control,1000000,63014,63014,126028,-873972,-87.3972,"Drama,Sci-Fi",5.4,97.0
84,"Jul 1, 2011",The Perfect Host,1000000,48764,51587,100351,-899649,-89.9649,"Comedy,Crime,Thriller",6.8,93.0
88,"Feb 13, 2015",Hits,1000000,15156,15156,30312,-969688,-96.9688,"Comedy,Drama",5.8,96.0
92,"Oct 17, 2014",Camp X-Ray,1000000,9837,101053,110890,-889110,-88.911,"Drama,War",6.9,117.0
94,"Apr 10, 2015",The Sisterhood of Night,1000000,6870,6870,13740,-986260,-98.626,"Drama,Mystery,Thriller",6.2,104.0
100,"Dec 31, 2013",Heli,1000000,0,552614,552614,-447386,-44.7386,"Crime,Drama,Romance",6.8,105.0
1,"Dec 31, 2015",Karachi se Lahore,1000000,0,17721,17721,-982279,-98.2279,"Adventure,Comedy,Family",6.6,143.0
3,"Dec 11, 2015",American Hero,1000000,0,26,26,-999974,-99.9974,"Action,Comedy,Drama",4.9,86.0
6,"Oct 24, 2003",The Party's Over,1000000,0,0,0,-1000000,-100.0,Drama,6.3,93.0
11,"Mar 20, 2012",Snow White: A Deadly Summer,1000000,0,0,0,-1000000,-100.0,Horror,2.2,83.0
12,"Oct 9, 2012",Truth or Die,1000000,0,0,0,-1000000,-100.0,"Horror,Mystery",5.6,96.0
13,"May 14, 2013",Black Rock,1000000,0,0,0,-1000000,-100.0,"Horror,Thriller",4.8,83.0
14,"Jan 7, 2014",Hidden Away,1000000,0,0,0,-1000000,-100.0,"Drama,Romance",7.1,96.0
15,"Oct 4, 2013",My Last Day Without You,1000000,0,0,0,-1000000,-100.0,"Comedy,Drama,Romance",5.7,90.0
16,"Oct 8, 2013",Zombie Hunter,1000000,0,0,0,-1000000,-100.0,"Action,Comedy,Horror",3.5,93.0
17,"Dec 31, 2014",Doc Holliday's Revenge,1000000,0,0,0,-1000000,-100.0,Western,3.8,84.0
18,"Jun 24, 2014",A Fine Step,1000000,0,0,0,-1000000,-100.0,Drama,5.4,111.0
19,"Feb 10, 2015",Fear Clinic,1000000,0,0,0,-1000000,-100.0,Horror,5.0,95.0
21,"Dec 31, 2014",Bang Bang Baby,1000000,0,0,0,-1000000,-100.0,"Drama,Fantasy,Musical",5.0,90.0
22,"Apr 8, 2016",Hush,1000000,0,0,0,-1000000,-100.0,"Drama,Thriller",4.5,103.0
22,"Apr 8, 2016",Hush,1000000,0,0,0,-1000000,-100.0,Documentary,4.8,100.0
22,"Apr 8, 2016",Hush,1000000,0,0,0,-1000000,-100.0,"Horror,Thriller",6.6,82.0
23,"Mar 1, 2016",1982,1000000,0,0,0,-1000000,-100.0,Drama,7.0,90.0
25,"Dec 31, 2016",Chemical Cut,1000000,0,0,0,-1000000,-100.0,Drama,5.4,83.0
26,"Dec 22, 2015",Por amor en el caserio,1000000,0,0,0,-1000000,-100.0,"Action,Drama,Romance",8.1,100.0
30,"Jan 10, 2014",Banshee Chapter,950000,0,78122,78122,-871878,-91.77663157894736,"Horror,Sci-Fi,Thriller",5.5,87.0
31,"Dec 31, 2012",Trance,950000,0,0,0,-950000,-100.0,Horror,4.6,83.0
31,"Dec 31, 2012",Trance,950000,0,0,0,-950000,-100.0,"Crime,Drama,Mystery",6.9,101.0
32,"Aug 12, 2014",Jesse,950000,0,0,0,-950000,-100.0,"Action,Crime,Drama",4.9,120.0
33,"Mar 3, 2015",Ask Me Anything,950000,0,0,0,-950000,-100.0,Drama,6.1,100.0
34,"Apr 13, 2012",L!fe Happens,930000,30905,30905,61810,-868190,-93.35376344086022,Comedy,5.6,100.0
35,"May 12, 2017",Lowriders,916000,6179955,6188421,12368376,11452376,1250.2593886462882,"Adventure,Crime,Drama",5.7,98.0
36,"Nov 21, 2014",Food Chains,913000,0,176,176,-912824,-99.98072289156626,Documentary,7.2,83.0
38,"Jul 12, 2013",Fruitvale Station,900000,16098998,17549645,33648643,32748643,3638.7381111111113,"Biography,Drama,Romance",7.5,85.0
39,"Apr 1, 2016",Meet the Blacks,900000,9097072,9097072,18194144,17294144,1921.5715555555555,"Comedy,Horror",5.9,94.0
41,"Aug 26, 2011",Circumstance,900000,454121,958978,1413099,513099,57.011,Drama,5.9,107.0
43,"Apr 27, 2012",The Giant Mechanical Man,900000,7396,7396,14792,-885208,-98.35644444444445,"Comedy,Drama,Romance",6.7,95.0
44,"Apr 5, 2013",The Brass Teapot,900000,6997,413733,420730,-479270,-53.25222222222222,"Comedy,Fantasy,Thriller",6.4,101.0
47,"Aug 13, 1942",Bambi,858000,102797000,268000000,370797000,369939000,43116.43356643357,"Biography,Documentary",7.0,58.0
50,"Mar 21, 2008",The Hammer,850000,442638,442638,885276,35276,4.150117647058823,"Biography,Drama,Sport",7.0,108.0
50,"Mar 21, 2008",The Hammer,850000,442638,442638,885276,35276,4.150117647058823,"Action,Adventure,Documentary",6.5,75.0
51,"Aug 28, 2015",Windsor Drive,850000,3256,3256,6512,-843488,-99.23388235294117,"Mystery,Thriller",3.2,90.0
52,"Dec 31, 2012",Snitch,850000,0,0,0,-850000,-100.0,"Action,Drama,Thriller",6.5,112.0
69,"Sep 19, 2014",Not Cool,800000,35688,35688,71376,-728624,-91.078,"Comedy,Drama,Romance",4.5,93.0
70,"Feb 3, 2012",Kill List,800000,29063,462206,491269,-308731,-38.591375,"Crime,Drama,Horror",6.4,95.0
71,"Jan 9, 2015",Vessel,800000,0,0,0,-800000,-100.0,"Adventure,Biography,Documentary",7.5,90.0
75,"Sep 9, 2011",Kevin Hart: Laugh at My Pain,750000,7706436,7712436,15418872,14668872,1955.8496000000002,"Comedy,Documentary",7.4,89.0
77,"Jun 8, 2012",Safety Not Guaranteed,750000,4010957,4422318,8433275,7683275,1024.4366666666667,"Comedy,Drama,Romance",7.0,86.0
78,"Feb 3, 2012",The Innkeepers,750000,78396,1011535,1089931,339931,45.324133333333336,"Drama,Horror,Mystery",5.5,101.0
84,"Dec 31, 2014",Destiny,750000,0,450,450,-749550,-99.94,"Drama,Music,Romance",7.8,105.0
86,"Jan 5, 2016",Adulterers,750000,0,0,0,-750000,-100.0,"Crime,Drama,Thriller",5.2,91.0
93,"Aug 4, 2017",Columbus,700000,1017107,1110511,2127618,1427618,203.94542857142858,Comedy,7.3,127.0
93,"Aug 4, 2017",Columbus,700000,1017107,1110511,2127618,1427618,203.94542857142858,Drama,7.2,104.0
93,"Aug 4, 2017",Columbus,700000,1017107,1110511,2127618,1427618,203.94542857142858,Comedy,5.8,85.0
96,"Mar 13, 2015",Walter,700000,0,0,0,-700000,-100.0,"Comedy,Drama",5.4,94.0
96,"Mar 13, 2015",Walter,700000,0,0,0,-700000,-100.0,Comedy,6.4,90.0
100,"Oct 11, 2013",Escape from Tomorrow,650000,171962,171962,343924,-306076,-47.08861538461539,"Drama,Fantasy,Horror",5.2,90.0
2,"Dec 31, 2012",After,650000,0,0,0,-650000,-100.0,"Drama,Mystery",4.7,99.0
2,"Dec 31, 2012",After,650000,0,0,0,-650000,-100.0,"Drama,Fantasy,Mystery",5.5,90.0
2,"Dec 31, 2012",After,650000,0,0,0,-650000,-100.0,Romance,6.3,83.0
2,"Dec 31, 2012",After,650000,0,0,0,-650000,-100.0,"Drama,Romance",5.6,105.0
3,"Dec 31, 2014",The Hadza: Last of the First,650000,0,0,0,-650000,-100.0,Documentary,7.7,71.0
5,"Dec 31, 2013",Treachery,625000,0,0,0,-625000,-100.0,"Drama,Thriller",3.7,67.0
12,"May 2, 2014",Water & Power,600000,42557,42557,85114,-514886,-85.81433333333334,"Crime,Drama",6.2,88.0
15,"May 22, 2015",Drunk Wedding,600000,3301,3301,6602,-593398,-98.89966666666666,Comedy,4.6,81.0
16,"Mar 4, 2016",They Will Have to Kill Us First,600000,0,7943,7943,-592057,-98.67616666666666,Documentary,7.3,100.0
18,"Aug 8, 2014",The Maid's Room,600000,0,0,0,-600000,-100.0,Thriller,4.5,98.0
19,"Dec 31, 2014",Light from the Darkroom,600000,0,0,0,-600000,-100.0,"Action,Drama,Thriller",6.1,90.0
20,"Feb 24, 2015",Irreplaceable,600000,0,0,0,-600000,-100.0,Documentary,7.5,109.0
20,"Feb 24, 2015",Irreplaceable,600000,0,0,0,-600000,-100.0,"Comedy,Drama",6.5,102.0
22,"Jul 29, 2011",The Harvest/La Cosecha,560000,3709,3709,7418,-552582,-98.67535714285715,Documentary,7.1,80.0
23,"Dec 31, 2015",Julija in alfa Romeo,560000,0,8462,8462,-551538,-98.48892857142857,Comedy,5.8,83.0
27,"Sep 12, 2014",Faith Connections,550000,9111,9111,18222,-531778,-96.6869090909091,"Biography,Documentary,Drama",7.1,115.0
28,"Mar 6, 2012",High Road,546173,0,0,0,-546173,-100.0,Comedy,5.4,87.0
30,"Nov 15, 1974",Benji,500000,31559560,31559560,63119120,62619120,12523.824,"Crime,Drama,Family",6.4,87.0
30,"Nov 15, 1974",Benji,500000,31559560,31559560,63119120,62619120,12523.824,"Documentary,Sport",7.4,79.0
39,"Jul 8, 2011",Sholem Aleichem: Laughing in the Darkness,500000,1131261,1131261,2262522,1762522,352.5044,Documentary,6.8,93.0
41,"Jun 9, 2000",Groove,500000,1115313,1167524,2282837,1782837,356.5674,"Drama,Music,Musical",8.4,87.0
45,"Aug 23, 2013",Drinking Buddies,500000,343706,407100,750806,250806,50.161199999999994,"Comedy,Drama,Romance",6.1,90.0
47,"Jul 12, 2002",Never Again,500000,307631,308793,616424,116424,23.2848,Drama,5.7,106.0
47,"Jul 12, 2002",Never Again,500000,307631,308793,616424,116424,23.2848,"Documentary,Music",6.6,69.0
50,"Oct 29, 2010",Monsters,500000,237301,5639730,5877031,5377031,1075.4062,"Drama,Sci-Fi,Thriller",6.4,94.0
50,"Oct 29, 2010",Monsters,500000,237301,5639730,5877031,5377031,1075.4062,Horror,4.0,87.0
52,"Apr 17, 2013",Deceptive Practice: The Mysteries and Mentors of Ricky Jay,500000,152449,152449,304898,-195102,-39.0204,Documentary,7.1,88.0
53,"Sep 28, 2012",The Other Dream Team,500000,134109,314444,448553,-51447,-10.2894,"Documentary,Sport",8.4,89.0
55,"Apr 1, 2011",Rubber,500000,100370,680914,781284,281284,56.2568,"Comedy,Fantasy,Horror",5.8,82.0
59,"Jul 11, 2003",The Journey,500000,19800,19800,39600,-460400,-92.08,"Adventure,Drama,Mystery",7.9,112.0
59,"Jul 11, 2003",The Journey,500000,19800,19800,39600,-460400,-92.08,"Comedy,Drama,Family",7.5,103.0
59,"Jul 11, 2003",The Journey,500000,19800,19800,39600,-460400,-92.08,Drama,6.6,94.0
59,"Jul 11, 2003",The Journey,500000,19800,19800,39600,-460400,-92.08,"Drama,Thriller",6.3,82.0
60,"Apr 23, 2009",Home,500000,15433,44793168,44808601,44308601,8861.7202,Drama,6.0,76.0
60,"Apr 23, 2009",Home,500000,15433,44793168,44808601,44308601,8861.7202,Drama,7.5,127.0
60,"Apr 23, 2009",Home,500000,15433,44793168,44808601,44308601,8861.7202,"Adventure,Animation,Comedy",6.6,94.0
60,"Apr 23, 2009",Home,500000,15433,44793168,44808601,44308601,8861.7202,"Drama,Romance",6.8,90.0
60,"Apr 23, 2009",Home,500000,15433,44793168,44808601,44308601,8861.7202,Drama,7.0,112.0
60,"Apr 23, 2009",Home,500000,15433,44793168,44808601,44308601,8861.7202,"Drama,Horror,Thriller",3.9,87.0
60,"Apr 23, 2009",Home,500000,15433,44793168,44808601,44308601,8861.7202,Drama,7.2,103.0
60,"Apr 23, 2009",Home,500000,15433,44793168,44808601,44308601,8861.7202,"Drama,Romance,Thriller",8.4,71.0
65,"Sep 10, 2014",Born to Fly: Elizabeth Streb vs. Gravity,500000,1822,1822,3644,-496356,-99.27120000000001,"Action,Biography,Documentary",6.7,82.0
66,"Jun 28, 2013",Detention of the Dead,500000,1778,1778,3556,-496444,-99.2888,"Action,Adventure,Comedy",4.6,87.0
67,"May 11, 2018",Higher Power,500000,528,528,1056,-498944,-99.7888,"Action,Sci-Fi,Thriller",5.3,93.0
72,"Dec 31, 2010",Drones,500000,0,0,0,-500000,-100.0,Comedy,6.4,98.0
72,"Dec 31, 2010",Drones,500000,0,0,0,-500000,-100.0,Thriller,4.5,82.0
73,"Apr 3, 2012",Enter Nowhere,500000,0,0,0,-500000,-100.0,"Mystery,Sci-Fi,Thriller",6.6,90.0
74,"Jul 17, 2012",Girls Gone Dead,500000,0,0,0,-500000,-100.0,"Comedy,Horror",3.5,104.0
77,"Jul 24, 2015",The Outrageous Sophie Tucker,500000,0,0,0,-500000,-100.0,Documentary,7.3,96.0
78,"Mar 10, 2015",Subconscious,500000,0,0,0,-500000,-100.0,Horror,4.5,72.0
78,"Mar 10, 2015",Subconscious,500000,0,0,0,-500000,-100.0,"Action,Mystery,Thriller",2.2,122.0
79,"Apr 14, 2015",Roadside,500000,0,0,0,-500000,-100.0,"Drama,Horror,Mystery",3.8,90.0
80,"Dec 31, 2014",Diamond Ruff,500000,0,0,0,-500000,-100.0,Action,4.3,82.0
81,"Feb 10, 2015",Love in the Time of Monsters,500000,0,0,0,-500000,-100.0,"Comedy,Horror",5.5,97.0
83,"Dec 31, 2015",Fight to the Finish,500000,0,0,0,-500000,-100.0,"Action,Romance,Sport",3.6,94.0
84,"Dec 31, 2013",Bucky and the Squirrels,500000,0,0,0,-500000,-100.0,Comedy,4.2,82.0
85,"Dec 31, 1990",Going Under,500000,0,0,0,-500000,-100.0,"Action,Horror,Thriller",6.3,83.0
85,"Dec 31, 1990",Going Under,500000,0,0,0,-500000,-100.0,Drama,8.2,49.0
86,"Jun 23, 2015",Crossroads,500000,0,0,0,-500000,-100.0,"Action,Crime,Drama",7.8,87.0
86,"Jun 23, 2015",Crossroads,500000,0,0,0,-500000,-100.0,"Drama,Mystery,War",6.1,116.0
86,"Jun 23, 2015",Crossroads,500000,0,0,0,-500000,-100.0,Documentary,8.7,65.0
87,"Aug 11, 2015",Alleluia! The Devil's Carnival,500000,0,0,0,-500000,-100.0,"Horror,Musical",6.9,97.0
89,"Dec 31, 2014",The Sound and the Shadow,500000,0,0,0,-500000,-100.0,"Comedy,Mystery,Thriller",7.9,90.0
90,"Dec 31, 2015",Rodeo Girl,500000,0,0,0,-500000,-100.0,"Adventure,Family",5.8,108.0
96,"Aug 22, 1997",Sunday,450000,410919,450349,861268,411268,91.39288888888889,"Drama,Romance",6.2,71.0
96,"Aug 22, 1997",Sunday,450000,410919,450349,861268,411268,91.39288888888889,"Crime,Drama",8.1,65.0
100,"Jul 11, 2014",As It Is in Heaven,450000,13486,13486,26972,-423028,-94.00622222222222,Drama,7.3,86.0
1,"Jul 1, 2014",Mutual Friends,450000,0,0,0,-450000,-100.0,"Comedy,Romance",6.5,86.0
7,"Apr 25, 2014",Blue Ruin,420000,258384,437002,695386,275386,65.56809523809524,"Crime,Drama,Thriller",7.1,90.0
12,"Oct 24, 2008",Heroes,400000,655538,655538,1311076,911076,227.76900000000003,Documentary,7.3,88.0
13,"Oct 6, 2004",Tarnation,400000,592014,1162014,1754028,1354028,338.507,"Comedy,Horror",3.5,90.0
14,"Oct 15, 2010",I Want Your Money,400000,433588,433588,867176,467176,116.794,Documentary,5.1,92.0
17,"Jul 27, 2001",Jackpot,400000,44452,44452,88904,-311096,-77.774,"Action,Comedy,Crime",6.6,86.0
17,"Jul 27, 2001",Jackpot,400000,44452,44452,88904,-311096,-77.774,"Comedy,Thriller",2.1,132.0
17,"Jul 27, 2001",Jackpot,400000,44452,44452,88904,-311096,-77.774,Comedy,6.7,92.0
17,"Jul 27, 2001",Jackpot,400000,44452,44452,88904,-311096,-77.774,"Comedy,Romance",7.8,150.0
28,"Jan 1, 1980",Maniac,350000,10000000,10000000,20000000,19650000,5614.285714285715,"Action,Horror,Thriller",4.8,160.0
28,"Jan 1, 1980",Maniac,350000,10000000,10000000,20000000,19650000,5614.285714285715,"Horror,Thriller",6.1,89.0
35,"Oct 20, 2015",Rotor DR1,350000,0,0,0,-350000,-100.0,"Family,Sci-Fi",3.4,98.0
37,"Oct 17, 1978",Halloween,325000,47000000,70000000,117000000,116675000,35900.0,"Horror,Thriller",6.6,106.0
51,"Mar 11, 2011",3 Backyards,300000,39475,39475,78950,-221050,-73.68333333333334,Drama,5.0,88.0
57,"Mar 28, 2014",Locker 13,300000,3496,3496,6992,-293008,-97.66933333333333,Thriller,4.7,90.0
58,"Oct 23, 2015",The Looking Glass,300000,1711,1711,3422,-296578,-98.85933333333334,Fantasy,5.5,80.0
58,"Oct 23, 2015",The Looking Glass,300000,1711,1711,3422,-296578,-98.85933333333334,"Drama,Music",5.8,110.0
59,"Oct 31, 2014",All You Need Is Love,300000,0,3565259,3565259,3265259,1088.4196666666667,Documentary,6.8,90.0
59,"Oct 31, 2014",All You Need Is Love,300000,0,3565259,3565259,3265259,1088.4196666666667,"Comedy,Romance",5.6,103.0
59,"Oct 31, 2014",All You Need Is Love,300000,0,3565259,3565259,3265259,1088.4196666666667,"Comedy,Romance",5.8,113.0
61,"Jul 3, 2012",Some Guy Who Kills People,300000,0,0,0,-300000,-100.0,"Comedy,Crime,Drama",6.3,97.0
62,"Aug 7, 2013",Midnight Cabaret,300000,0,0,0,-300000,-100.0,"Action,Crime,Drama",6.4,78.0
63,"Mar 10, 2015",Teeth and Blood,300000,0,0,0,-300000,-100.0,"Action,Horror",4.0,96.0
65,"Dec 31, 2010",Anderson's Cross,300000,0,0,0,-300000,-100.0,"Comedy,Drama,Romance",5.5,98.0
66,"Dec 8, 2015",Amidst the Devil's Wings,300000,0,0,0,-300000,-100.0,"Action,Crime,Drama",4.0,90.0
67,"Dec 31, 2010",Death Calls,290000,0,0,0,-290000,-100.0,"Action,Adventure,Mystery",4.6,90.0
68,"Aug 17, 2012",Compliance,270000,319285,830700,1149985,879985,325.92037037037034,"Biography,Crime,Drama",6.4,90.0
69,"May 1, 1981",Graduation Day,250000,23894000,23894000,47788000,47538000,19015.199999999997,Thriller,5.0,75.0
72,"Apr 28, 2017",Sleight,250000,3930990,3934450,7865440,7615440,3046.1760000000004,"Action,Drama,Sci-Fi",5.9,89.0
74,"Oct 28, 2011",Like Crazy,250000,3395391,3728400,7123791,6873791,2749.5164,"Drama,Romance",6.7,86.0
74,"Oct 28, 2011",Like Crazy,250000,3395391,3728400,7123791,6873791,2749.5164,"Comedy,Drama",7.2,116.0
79,"Mar 28, 1997",Love and Other Catastrophes,250000,212285,743216,955501,705501,282.2004,"Comedy,Drama",5.8,100.0
81,"Jul 22, 2005",November,250000,191862,191862,383724,133724,53.4896,"Drama,Fantasy,Horror",7.2,115.0
83,"Mar 28, 2008",Happy Valley,250000,67665,67665,135330,-114670,-45.867999999999995,"Documentary,Drama,Sport",7.1,98.0
84,"Aug 2, 2013",The Canyons,250000,59671,62375,122046,-127954,-51.1816,"Drama,Thriller",3.8,99.0
89,"Jun 6, 2014",Test,250000,18823,18823,37646,-212354,-84.9416,Drama,6.2,89.0
89,"Jun 6, 2014",Test,250000,18823,18823,37646,-212354,-84.9416,Drama,7.2,96.0
91,"Mar 24, 2015",Along the Roadside,250000,0,3234,3234,-246766,-98.7064,"Comedy,Music,Romance",6.8,108.0
93,"Oct 5, 2010",Rust,250000,0,0,0,-250000,-100.0,Drama,5.6,95.0
93,"Oct 5, 2010",Rust,250000,0,0,0,-250000,-100.0,Drama,6.1,109.0
93,"Oct 5, 2010",Rust,250000,0,0,0,-250000,-100.0,"Horror,Thriller",6.1,75.0
93,"Oct 5, 2010",Rust,250000,0,0,0,-250000,-100.0,Drama,6.6,100.0
94,"Dec 31, 2010",The Christmas Bunny,250000,0,0,0,-250000,-100.0,"Drama,Family",6.1,98.0
96,"Dec 18, 2012",The Frozen,250000,0,0,0,-250000,-100.0,"Drama,Thriller",4.4,95.0
98,"Dec 31, 2010",Butterfly,250000,0,0,0,-250000,-100.0,"Horror,Thriller",4.7,90.0
98,"Dec 31, 2010",Butterfly,250000,0,0,0,-250000,-100.0,"Comedy,Drama,Romance",6.2,103.0
98,"Dec 31, 2010",Butterfly,250000,0,0,0,-250000,-100.0,"Documentary,Sport",7.8,80.0
99,"Feb 3, 2015",UnDivided,250000,0,0,0,-250000,-100.0,Documentary,8.4,66.0
100,"Dec 31, 2014",Horse Camp,250000,0,0,0,-250000,-100.0,Family,6.7,108.0
1,"Feb 24, 2015",Give Me Shelter,250000,0,0,0,-250000,-100.0,Documentary,7.6,90.0
3,"Dec 31, 2015",Shooting the Warwicks,250000,0,0,0,-250000,-100.0,"Comedy,Drama",6.1,95.0
5,"Oct 9, 2015",Western Religion,250000,0,0,0,-250000,-100.0,"Adventure,Drama,Fantasy",4.0,105.0
10,"Jul 20, 2012",Burn,225000,1109276,1109276,2218552,1993552,886.023111111111,Documentary,7.5,86.0
16,"Oct 18, 1996",Swingers,200000,4505922,6618578,11124500,10924500,5462.25,Comedy,6.7,85.0
16,"Oct 18, 1996",Swingers,200000,4505922,6618578,11124500,10924500,5462.25,Comedy,4.2,86.0
18,"Feb 25, 2011",The Grace Card,200000,2430735,2430735,4861470,4661470,2330.735,Drama,6.6,101.0
21,"Jun 19, 2015",The Overnight,200000,1109808,1165996,2275804,2075804,1037.902,"Comedy,Mystery",6.1,79.0
23,"Oct 12, 2012",Middle of Nowhere,200000,236806,236806,473612,273612,136.806,Drama,6.4,97.0
26,"May 10, 2002",Hybrid,200000,162605,162605,325210,125210,62.605,"Documentary,Sport",7.2,104.0
29,"Sep 9, 2005",Side Effects,200000,44701,44701,89402,-110598,-55.299,"Crime,Drama,Mystery",7.1,106.0
33,"Mar 14, 2014",The Word,200000,3648,3648,7296,-192704,-96.352,Drama,6.7,104.0
33,"Mar 14, 2014",The Word,200000,3648,3648,7296,-192704,-96.352,"Drama,Thriller",4.9,97.0
38,"Sep 12, 2014",Archaeology of a Woman,200000,0,0,0,-200000,-100.0,Drama,7.9,94.0
39,"Aug 26, 2014",Sanctuary; Quite a Conundrum,200000,0,0,0,-200000,-100.0,"Comedy,Horror,Thriller",5.4,82.0
40,"Sep 29, 2015",Theresa Is a Mother,200000,0,0,0,-200000,-100.0,"Comedy,Drama,Music",6.8,105.0
41,"Nov 10, 2015",Perfect Cowboy,200000,0,0,0,-200000,-100.0,Drama,5.9,109.0
42,"Dec 31, 2014",H.,200000,0,0,0,-200000,-100.0,"Drama,Sci-Fi,Thriller",5.9,93.0
43,"Sep 23, 2011",Weekend,190000,484592,1577585,2062177,1872177,985.3563157894737,"Drama,Romance",7.6,97.0
43,"Sep 23, 2011",Weekend,190000,484592,1577585,2062177,1872177,985.3563157894737,"Action,Comedy,Crime",4.0,121.0
43,"Sep 23, 2011",Weekend,190000,484592,1577585,2062177,1872177,985.3563157894737,Horror,3.8,71.0
45,"Feb 27, 2015",Butterfly Girl,180000,17503,17503,35006,-144994,-80.55222222222223,Documentary,8.6,78.0
48,"Jul 22, 2011",Another Earth,175000,1321194,2102779,3423973,3248973,1856.556,"Drama,Romance,Sci-Fi",7.0,92.0
49,"Aug 23, 2013",Sparrows Dance,175000,2602,2602,5204,-169796,-97.0262857142857,"Comedy,Drama,Romance",6.8,81.0
50,"Sep 4, 2015",Heroes of Dirt,175000,0,0,0,-175000,-100.0,"Action,Drama,Sport",6.7,98.0
51,"Jun 3, 2016",The Fits,170000,166425,169242,335667,165667,97.45117647058822,"Drama,Music",6.7,72.0
55,"Mar 1, 2002",The Calling,160000,32092,32092,64184,-95816,-59.885,"Drama,Thriller",5.8,108.0
55,"Mar 1, 2002",The Calling,160000,32092,32092,64184,-95816,-59.885,Biography,6.7,46.0
61,"Aug 21, 2015",Top Spin,150000,5858,5858,11716,-138284,-92.18933333333334,Documentary,6.9,80.0
62,"Dec 31, 2013",Speak No Evil,150000,0,32927,32927,-117073,-78.04866666666666,Horror,3.6,74.0
64,"May 3, 2013",Aroused,150000,0,0,0,-150000,-100.0,Documentary,5.3,66.0
68,"Apr 27, 2012",Sound of My Voice,135000,408015,429448,837463,702463,520.342962962963,"Drama,Mystery,Sci-Fi",6.6,85.0
70,"Jul 18, 2014",An American in Hollywood,125000,0,0,0,-125000,-100.0,Drama,7.3,89.0
71,"Aug 11, 2015",The Brain That Sings,125000,0,0,0,-125000,-100.0,"Documentary,Family",7.9,62.0
73,"Jun 15, 2012",Your Sister's Sister,120000,1597486,3090593,4688079,4568079,3806.7324999999996,"Comedy,Drama",6.7,90.0
77,"Oct 1, 1968",Night of the Living Dead,114000,12087064,30087064,42174128,42060128,36894.84912280702,Horror,5.3,79.0
78,"Feb 8, 1915",The Birth of a Nation,110000,10000000,11000000,21000000,20890000,18990.909090909092,"Biography,Drama,History",6.4,120.0
80,"Jul 10, 2015",The Gallows,100000,22764410,41656474,64420884,64320884,64320.884,"Horror,Mystery,Thriller",4.2,81.0
86,"Jul 7, 2017",A Ghost Story,100000,1594798,2769782,4364580,4264580,4264.58,"Drama,Fantasy,Romance",6.8,92.0
89,"Mar 21, 2014",Cheap Thrills,100000,59424,59424,118848,18848,18.848000000000003,"Comedy,Crime,Drama",6.7,88.0
90,"Jun 19, 2014",The Past is a Grotesque Animal,100000,20056,20056,40112,-59888,-59.888,"Biography,Documentary,Music",7.2,77.0
92,"May 18, 2012",Indie Game: The Movie,100000,0,0,0,-100000,-100.0,"Documentary,Drama",7.7,103.0
94,"Jun 10, 2014",Echo Dr.,100000,0,0,0,-100000,-100.0,"Action,Drama,Sci-Fi",3.6,81.0
95,"Mar 17, 2015",Closure,100000,0,0,0,-100000,-100.0,Thriller,5.5,95.0
95,"Mar 17, 2015",Closure,100000,0,0,0,-100000,-100.0,"Comedy,Drama,Romance",7.9,72.0
95,"Mar 17, 2015",Closure,100000,0,0,0,-100000,-100.0,"Adventure,Biography,Documentary",8.0,76.0
95,"Mar 17, 2015",Closure,100000,0,0,0,-100000,-100.0,Drama,6.4,62.0
95,"Mar 17, 2015",Closure,100000,0,0,0,-100000,-100.0,"Comedy,Drama",7.9,90.0
97,"Mar 25, 2015",Open Secret,100000,0,0,0,-100000,-100.0,Documentary,6.5,55.0
98,"Nov 10, 2015",The Night Visitor,100000,0,0,0,-100000,-100.0,"Horror,Sci-Fi,Thriller",4.8,91.0
99,"Jul 7, 2015",Tiger Orange,100000,0,0,0,-100000,-100.0,Drama,6.6,75.0
2,"Jul 17, 2015",Dawn of the Crescent Moon,75000,8799,8799,17598,-57402,-76.536,"Drama,Sci-Fi,Thriller",5.1,95.0
3,"Sep 29, 2015",Queen Crab,75000,0,0,0,-75000,-100.0,"Action,Sci-Fi,Thriller",4.2,80.0
4,"Jul 25, 2014",Happy Christmas,70000,30312,30312,60624,-9376,-13.394285714285715,"Comedy,Drama",5.5,82.0
6,"Dec 31, 2011",Absentia,70000,0,8555,8555,-61445,-87.77857142857142,"Drama,Horror,Mystery",5.8,87.0
11,"Jan 25, 2013",Supporting Characters,60000,4917,4917,9834,-50166,-83.61,Comedy,6.4,87.0
12,"Mar 16, 2012",The FP,60000,0,0,0,-60000,-100.0,Comedy,5.6,82.0
13,"Dec 31, 2012",Hayride,60000,0,0,0,-60000,-100.0,"Crime,Drama,Horror",3.4,93.0
15,"Oct 4, 2013",The Dirties,55000,0,0,0,-55000,-100.0,"Crime,Drama",6.8,83.0
18,"Nov 12, 2010",Tiny Furniture,50000,391674,424149,815823,765823,1531.646,"Comedy,Drama,Romance",6.2,98.0
19,"Feb 22, 2008",The Signal,50000,251150,406299,657449,607449,1214.898,"Drama,Mystery,Sci-Fi",6.1,97.0
20,"Jul 31, 2015",Counting,50000,8374,8374,16748,-33252,-66.50399999999999,Documentary,6.0,111.0
22,"Feb 14, 2014",Down and Dangerous,50000,0,0,0,-50000,-100.0,"Crime,Thriller",5.2,95.0
24,"Aug 4, 2015",Bending Steel,50000,0,0,0,-50000,-100.0,Documentary,7.9,92.0
25,"Sep 1, 2015","Run, Hide, Die",50000,0,0,0,-50000,-100.0,"Horror,Thriller",3.5,104.0
26,"Dec 31, 2014",The Image Revolution,50000,0,0,0,-50000,-100.0,"Biography,Documentary",7.2,81.0
27,"Oct 25, 2013",A True Story,45000,0,0,0,-45000,-100.0,Comedy,5.2,96.0
29,"Jun 21, 2013",This Is Martin Bonner,42000,0,0,0,-42000,-100.0,Drama,6.6,83.0
32,"Feb 11, 2011",Raymond Did It,40000,3632,3632,7264,-32736,-81.84,Horror,3.3,83.0
33,"Mar 31, 2012",Foreign Letters,40000,0,0,0,-40000,-100.0,"Comedy,Drama",6.9,99.0
35,"Oct 25, 2013",Her Cry: La Llorona Investigation,35000,0,0,0,-35000,-100.0,Horror,3.7,89.0
36,"Dec 31, 2014",Happy 40th,35000,0,0,0,-35000,-100.0,Drama,6.3,100.0
38,"Mar 18, 2016",Krisha,30000,144822,144822,289644,259644,865.48,Drama,7.2,83.0
45,"Jan 27, 2017",Emily,27000,3547,3547,7094,-19906,-73.72592592592594,Drama,6.8,83.0
49,"Sep 1, 2015",Exeter,25000,0,489792,489792,464792,1859.1680000000001,"Horror,Mystery,Thriller",4.5,91.0
51,"Apr 21, 2015",Ten,25000,0,0,0,-25000,-100.0,Drama,5.5,118.0
51,"Apr 21, 2015",Ten,25000,0,0,0,-25000,-100.0,"Adventure,Horror,Mystery",5.4,83.0
51,"Apr 21, 2015",Ten,25000,0,0,0,-25000,-100.0,"Horror,Mystery,Thriller",4.7,82.0
52,"Dec 1, 2015",Dutch Kills,25000,0,0,0,-25000,-100.0,"Crime,Drama,Thriller",5.1,90.0
54,"Dec 31, 2014",Dry Spell,22000,0,0,0,-22000,-100.0,"Comedy,Romance",3.3,90.0
56,"Jan 4, 2013",All Superheroes Must Die,20000,0,0,0,-20000,-100.0,"Sci-Fi,Thriller",4.0,78.0
59,"Nov 25, 2011",The Ridges,17300,0,0,0,-17300,-100.0,"Drama,Horror,Thriller",2.9,89.0
62,"Dec 31, 2014",Stories of Our Lives,15000,0,0,0,-15000,-100.0,Drama,7.5,60.0
68,"Jul 6, 2001",Cure,10000,94596,94596,189192,179192,1791.92,Drama,4.9,93.0
73,"Jan 13, 2012",Newlyweds,9000,4584,4584,9168,168,1.866666666666667,"Comedy,Drama",6.4,95.0
78,"Dec 31, 2018",Red 11,7000,0,0,0,-7000,-100.0,"Horror,Sci-Fi,Thriller",5.6,77.0
81,"Sep 29, 2015",A Plague So Pleasant,1400,0,0,0,-1400,-100.0,"Drama,Horror,Thriller",5.4,76.0
